inquirer	inquirer
antiques	antigÃ¼edades
liquidation	liquidaciÃ³n
patterned	estampados
lakewood	lakewood
relentless	implacable
relentless	incansable
relentless	incesante
relentless	implacables
dwellers	moradores
inefficient	ineficacia
inefficient	ineficaz
inefficient	ineficiente
inefficient	ineficaces
inefficient	ineficiencia
inefficient	ineficientes
olomouc	olomouc
lineages	linajes
embryonic	embrionarias
bieber	bieber
inspected	inspeccionÃ³
inspected	inspeccionados
inspected	inspeccionado
offaly	offaly
gladly	gustosamente
loki	loki
retribution	retribuciÃ³n
chores	tareas
chores	quehaceres
jaffa	jaffa
pÃ¨re	pÃ¨re
nye	nye
ajay	aja
ajay	ajay
grievances	agravios
clio	clio
skinny	flaca
skinny	flaco
romanticism	romanticismo
connotations	connotaciÃ³n
connotations	connotaciones
fractional	fraccionada
dignitaries	dignatarios
monza	monza
compensated	compensados
compensated	compensado
compensated	compensada
nagy	nagy
pivot	pivote
saud	saud
practising	practicando
practising	practicar
minuscule	minÃºscula
minuscule	minÃºsculo
minuscule	minÃºsculas
spying	espionaje
spying	espiar
spying	espiando
woodruff	woodruff
couture	costura
couture	couture
clÃ©ment	clÃ©ment
infielder	infielder
opaque	opaco
opaque	opaca
blum	blum
overthrown	derrocado
shipyards	astilleros
capitalize	capitalizar
farce	farsa
pavia	pavÃ­a
gurney	camilla
condemn	condene
condemn	condenar
gleason	gleason
terrence	terrence
visas	visados
visas	visado
visas	visas
malice	malicia
sidewalk	acera
sidewalk	vereda
noms	noms
malignant	malignas
malignant	maligna
malignant	maligno
malignant	malignos
patriarchs	patriarcas
stooges	chiflados
shack	shack
shack	choza
chhattisgarh	chhattisgarh
subaru	subaru
beware	cuÃ­date
beware	cuidado
smiths	smiths
woolf	woolf
lisp	lisp
operetta	opereta
baseless	infundado
baseless	infundada
baseless	infundadas
midday	mediodÃ­a
zhong	zhong
malagasy	malgache
malagasy	malgaches
vat	iva
liberator	liberador
liberator	libertador
pens	cercados
pens	corrales
pens	bolÃ­grafos
pens	plumas
carpets	tapices
carpets	alfombras
doomsday	doomsday
vin	vin
normans	normandos
meek	meek
meek	manso
kal	kal
khrushchev	khrushchev
bearded	barba
bearded	barbuda
bearded	barbudo
bitten	mordido
coxeter	coxeter
bandung	bandung
edmonds	edmonds
pennington	pennington
rajendra	rajendra
kirkpatrick	kirkpatrick
lowercase	minÃºsculas
lowercase	minÃºscula
migrations	migraciÃ³n
migrations	migraciones
demetrius	demetrio
densities	densidades
brecht	brecht
harbin	harbin
ashram	ashram
celine	celine
obtains	obtiene
meteorologist	meteorÃ³logo
upanishad	upaniá¹£ad
tendon	tendÃ³n
coltrane	coltrane
yell	gritar
topo	topo
monstrous	monstruosa
monstrous	monstruoso
protons	protones
pence	peniques
drayton	drayton
barbed	pÃºas
bounced	rebotÃ³
chromium	cromo
friendships	amistades
diets	dietas
suleiman	suleiman
plummer	plummer
univision	univision
deficits	dÃ©ficit
deficits	dÃ©ficits
unfairly	injustamente
schÃ¤ffer	schÃ¤ffer
constituting	constituyendo
twickenham	twickenham
lombardi	lombardi
alonzo	alonso
alonzo	alonzo
underwear	calzones
underwear	calzoncillos
passer	passer
hyatt	hyatt
hasbro	hasbro
induces	induce
stork	cigÃ¼eÃ±a
sarcasm	sarcasmo
dewan	dewan
guillotine	guillotina
expel	expulsar
palsy	parÃ¡lisis
attendants	asistentes
justifies	justifica
kieran	kieran
lagrange	lagrange
tully	tully
mosul	mosul
massacred	masacrados
revere	revere
discriminate	discriminar
discriminate	discrimina
rewarding	recompensar
rewarding	gratificante
rewarding	premiar
stara	stara
pesos	pesos
nikolaus	nikolaus
leibniz	leibniz
ravaged	asolado
ravaged	devastado
bennington	bennington
thunderstorms	tormentas
dowling	dowling
vienne	vienne
decisively	decisivamente
cro	cro
reels	rollos
reels	bobina
reels	bobinas
kangaroos	canguros
mou	memorando
globo	globo
fab	fab
salam	salam
remo	remo
tatars	tÃ¡rtaros
adnan	adnan
tajik	tayikos
tajik	tayikistÃ¡n
tajik	tayiko
howrah	howrah
yarra	yarra
wheatley	wheatley
kumamoto	kumamoto
ibiza	ibiza
tray	bandeja
tulip	tulipanes
tulip	tulip
leila	leila
stearns	stearns
interfered	interferido
resettlement	reasentamiento
resettlement	reinstalaciÃ³n
keywords	keywords
experimentally	experimentalmente
catechism	catecismo
mansur	mansur
anas	anas
polluted	contaminadas
polluted	contaminados
polluted	contaminado
polluted	contaminada
azteca	azteca
grotto	gruta
lured	atraÃ­do
lured	atraÃ­dos
schuylkill	schuylkill
herbarium	herbario
incense	incienso
equinox	equinoccio
motogp	motogp
ohl	ohl
hotchkiss	hotchkiss
latency	latencia
ornamentation	ornamentaciÃ³n
altai	altai
gÃ¼nter	gÃ¼nter
attica	Ã¡tica
azam	azam
clarion	clarion
sirens	sirenas
punishable	punible
natchez	natchez
moira	moira
polygamy	poligamia
npb	npb
animosity	animosidad
sayyid	sayyid
beresford	beresford
wiseman	wiseman
mercia	mercia
scottsdale	scottsdale
zorn	zorn
samaritan	samaritano
reappears	reaparece
sensibility	sensibilidad
rockhampton	rockhampton
distrust	desconfianza
reorganised	reorganizado
reorganised	reorganizÃ³
agnew	agnew
armin	armin
misrepresented	tergiversado
moulton	moulton
hikers	excursionistas
janus	janus
xing	xing
gourmet	gourmet
debian	debian
fluorescence	fluorescencia
parkes	parkes
addendum	adiciÃ³n
klux	klux
inequalities	desigualdades
kubrick	kubrick
zapata	zapata
keats	keats
urs	urs
camped	acampado
janine	janine
usurp	usurpar
optimize	optimizar
optimize	optimiza
optimize	optimizaciÃ³n
refine	refinar
refine	perfeccionar
bielefeld	bielefeld
gard	gard
procured	adquiridos
wac	wac
lichtenstein	liechtenstein
lichtenstein	lichtenstein
macedon	macedonia
teixeira	teixeira
struts	puntales
cagayan	cagayan
fermanagh	fermanagh
tph	tph
staggered	escalonados
staggered	escalonada
beryl	beryl
microphones	micrÃ³fonos
broome	broome
sully	sully
loot	botÃ­n
loot	saqueo
navsource	navsource
therese	therese
mortgages	hipotecas
mortgages	hipoteca
abode	morada
thesaurus	tesauro
thesaurus	sinÃ³nimos
hips	caderas
hips	cadera
carnage	matanza
carnage	carnicerÃ­a
fahrenheit	fahrenheit
medically	mÃ©dicamente
suwon	suwon
subiaco	subiaco
safavid	safÃ¡vida
poitiers	poitiers
clinically	clÃ­nicamente
krauss	krauss
ncis	ncis
rem	rem
warhammer	warhammer
mollusc	molusco
mollusc	moluscos
carrillo	carrillo
lili	lili
everlasting	eterna
everlasting	eterno
peek	vistazo
restitution	restituciÃ³n
correa	correa
idealism	idealismo
glutamate	glutamato
maoist	maoÃ­stas
maoist	maoÃ­sta
habitable	habitable
adverts	anuncios
bachelors	solteros
porous	porosa
edwardian	eduardiano
pectoral	pectoral
pectoral	pectorales
phantoms	fantasmas
primordial	primordial
primordial	primordiales
ibsen	ibsen
vocation	vocaciÃ³n
mihai	mihai
remorse	remordimiento
remorse	arrepentimiento
remorse	remordimientos
phenomenal	fenomenal
bitcoin	bitcoin
rath	rath
extremists	extremistas
blankets	mantas
Ã³scar	Ã³scar
taro	taro
luoyang	luoyang
herbaceous	herbÃ¡cea
herbaceous	herbÃ¡ceas
herbaceous	herbÃ¡ceos
stride	stride
shaved	afeitado
epping	epping
contemplated	contemplaba
contemplated	contemplado
contemplated	contemplada
haste	prisa
characterizes	caracteriza
germantown	germantown
franciscans	franciscanos
gypsies	gitanos
tyrosine	tirosina
acapulco	acapulco
vor	vor
navratilova	navratilova
felton	felton
hallucinations	alucinaciones
biden	biden
rayner	rayner
cbi	cbi
dividends	dividendos
capsized	volcÃ³
tomsk	tomsk
clustering	agrupamiento
clustering	agrupaciÃ³n
pid	pid
cordelia	cordelia
taoist	taoÃ­sta
flak	flak
coercion	coerciÃ³n
coercion	coacciÃ³n
husky	husky
bailiff	intendente
bailiff	alguacil
disapproved	rechazados
disapproved	rechazado
jodie	jodie
valenciennes	valenciennes
invocation	invocaciÃ³n
querÃ©taro	querÃ©taro
chia	chia
vitality	vitalidad
ittihad	ittihad
chilling	refrigeraciÃ³n
chilling	escalofriante
virtualization	virtualizaciÃ³n
radniÄki	radniÄki
glamorous	glamoroso
clears	aclara
clears	despeja
armÃ©e	armÃ©e
sncf	sncf
waiver	exenciÃ³n
waiver	dispensa
waiver	renuncia
bartolomeo	bartolomeo
loom	telar
publius	publio
mena	mena
transnistria	transnistria
livonia	livonia
mellow	apacible
mellow	suave
incendiary	incendiario
mchale	mchale
graft	injerto
graft	injertos
evert	evert
freeport	freeport
segovia	segovia
phage	fago
nicotine	nicotina
biosynthesis	biosÃ­ntesis
woodside	woodside
principalities	principados
beyer	beyer
morelos	morelos
democracies	democracias
coburn	coburn
steaming	humeante
schreiber	schreiber
dine	cenar
rapture	rapto
hinge	bisagras
hinge	bisagra
femmes	femmes
aliases	alias
kleine	kleine
anomalous	anÃ³mala
applauded	aplaudiÃ³
aha	ajÃ¡
scarf	bufanda
scarf	paÃ±uelo
sorrows	penas
sorrows	tristezas
skunk	mofeta
goths	godos
sylvain	sylvain
fooled	engaÃ±ado
fooled	engaÃ±ados
fooled	engaÃ±ada
asymmetrical	asimÃ©trica
asymmetrical	asimÃ©trico
typhoid	tifus
typhoid	tifoidea
poirot	poirot
yugoslavian	yugoslavos
yugoslavian	yugoslava
yugoslavian	yugoslavo
hurd	hurd
torrens	torrens
jervis	jervis
goebbels	goebbels
workmen	trabajadores
workmen	obreros
irritated	irritado
romanov	romanov
ise	ise
dismissive	desdeÃ±osa
maids	criadas
maids	sirvientas
maids	doncellas
hedwig	hedwig
lilac	lila
lilac	lilas
magister	magister
disparaging	despectivo
lewisham	lewisham
denham	denham
goldwater	goldwater
Ã¶rebro	Ã¶rebro
timberwolves	timberwolves
relaunch	relanzar
relaunch	relanzamiento
eglinton	eglinton
estes	estes
proactive	proactiva
proactive	proactivo
niven	niven
lagoons	lagunas
tucumÃ¡n	tucumÃ¡n
khabarovsk	jabÃ¡rovsk
sag	sag
alternates	alternos
alternates	suplentes
alternates	alterna
placements	ubicaciones
placements	colocaciones
unloaded	descargada
discounts	rebajas
discounts	descuentos
discounts	promociones
discounts	descuento
abdicated	abdicÃ³
nesbitt	nesbitt
seong	seong
shetty	shetty
dipping	mojar
crt	crt
firsts	primeras
firsts	primeros
basu	basu
kerrang	kerrang
butts	traseros
butts	culos
butts	colillas
persuading	persuadir
braces	tirantes
braces	ortodoncia
pte	pte
byway	byway
romulus	romulus
rocca	rocca
ghostly	fantasmal
oberon	oberon
quell	sofocar
orne	orne
mediators	mediadores
limp	cojera
kino	kino
grandsons	nietos
brat	mocoso
croce	croce
denominator	denominador
kya	kya
clem	clem
newsroom	redacciÃ³n
goryeo	goryeo
lynda	lynda
dodo	dodo
lte	lte
gopher	gopher
bauhaus	bauhaus
mitochondria	mitocondrias
evgeny	evgeny
dentists	dentistas
dentists	dentista
gon	gon
glynn	glynn
msp	msp
fingerprints	huellas
flipping	volteando
wingate	wingate
vistula	vÃ­stula
zoltÃ¡n	zoltÃ¡n
bastille	bastilla
schott	schott
cuyahoga	cuyahoga
docklands	docklands
wallonia	valonia
qajar	qayar
cns	cns
cns	snc
unlucky	desafortunados
unlucky	desafortunado
unlucky	desafortunada
matte	mate
webcam	webcam
unter	unter
enfant	enfant
dessau	dessau
reconstructions	reconstrucciones
lebron	lebron
respondent	demandado
respondent	demandados
coniferous	conÃ­feras
oni	oni
rolando	rolando
countermeasures	contramedidas
windshield	parabrisas
preÅ¡ov	preÅ¡ov
bloemfontein	bloemfontein
sewn	cosido
heston	heston
chrysalis	crisÃ¡lida
intercultural	interculturales
intercultural	intercultural
giorgi	giorgi
contemplating	contemplando
contemplating	contemplar
swampy	pantanoso
genitalia	genital
genitalia	genitales
gad	gad
mears	mears
bookshop	librerÃ­a
maggiore	maggiore
iau	uai
missa	missa
diluted	diluido
drago	drago
mammalia	mammalia
yui	yui
hilliard	hilliard
crowther	crowther
inks	tintas
weathering	meteorizaciÃ³n
peloponnese	peloponeso
marissa	marissa
dimitrov	dimitrov
radiating	irradiando
nightfall	anochecer
bowery	bowery
sequenced	secuenciado
streptomyces	streptomyces
angoulÃªme	angulema
smt	smt
monolithic	monolÃ­tico
hostels	hostales
hostels	albergues
roxas	roxas
mombasa	mombasa
cca	cca
cca	ecp
blas	blas
barros	barros
gatwick	gatwick
piloting	pilotaje
rampart	rampart
rampart	muralla
putney	putney
forza	forza
lowndes	lowndes
deptford	deptford
deadlock	estancamiento
gonÃ§alves	gonÃ§alves
vestibule	vestÃ­bulo
manta	manta
shabab	shabab
divination	adivinaciÃ³n
cayuga	cayuga
divisione	divisione
helios	helios
morelia	morelia
altrincham	altrincham
beige	beige
dalmatian	dÃ¡lmata
rutledge	rutledge
bionic	biÃ³nico
inclusions	inclusiones
pfa	pfa
bdsm	bdsm
banskÃ¡	banskÃ¡
neve	neve
tribeca	tribeca
rasmus	rasmus
hattie	hattie
sade	sade
bhattacharya	bhattacharya
manus	manus
osvaldo	osvaldo
sangam	sangam
paramedic	paramÃ©dico
paramedic	paramÃ©dicos
admirers	admiradores
anglicanism	anglicanismo
gorica	gorica
barak	barak
hybridization	hibridaciÃ³n
hsieh	hsieh
hamstring	corva
positional	posicional
shoshone	shoshone
necessities	necesidades
biopsy	biopsia
baring	baring
cheetahs	guepardos
holby	holby
exalted	exaltado
fortaleza	fortaleza
baronies	baronÃ­as
beebe	beebe
taichung	taichung
cheering	animar
cheering	animando
cheering	alentando
martÃ­	martÃ­
atr	atr
visualize	visualizar
visualize	visualiza
oakville	oakville
safeguards	salvaguardias
safeguards	salvaguarda
dogmatic	dogmÃ¡tica
asymptotic	asintÃ³tica
capillary	capilar
capillary	capilares
canoeist	piragÃ¼ista
galle	galle
exclaim	exclamar
liberec	liberec
czechs	checos
sata	sata
colonna	colonna
greaves	chicharrones
monrovia	monrovia
hula	hula
dilip	dilip
mahan	mahan
davos	davos
cordial	cordial
cordial	cordiales
baez	baez
hossain	hossain
brompton	brompton
kama	kama
demarcation	demarcaciÃ³n
demarcation	delimitaciÃ³n
diagnoses	diagnÃ³sticos
parrott	parrott
gleeson	gleeson
buoy	boya
pikes	picas
paramedics	paramÃ©dicos
paramedics	paramÃ©dico
udaipur	udaipur
dossier	dossier
dossier	expediente
geddes	geddes
canvases	lienzos
amulet	amuleto
ingested	ingerido
caricatures	caricaturas
embodies	encarna
cubans	cubanos
spinoza	spinoza
sÃ¨vres	sÃ¨vres
bathtub	baÃ±era
uribe	uribe
mccarty	mccarty
oem	oem
parenthesis	parÃ©ntesis
mawson	mawson
melts	derrite
melts	funde
supercharged	sobrealimentado
mythic	mÃ­tico
mythic	mÃ­tica
hoe	azada
chipping	chipping
bau	bau
abbeville	abbeville
calamity	calamidades
calamity	calamidad
flavius	flavio
unoccupied	desocupada
korda	korda
differentiable	diferenciable
uterine	uterino
idioms	modismos
lajos	lajos
bovine	bovina
bovine	vacuno
bovine	bovino
bovine	bovinos
angelou	angelou
obliquely	oblicuamente
cede	ceder
telepathic	telepatÃ­a
telepathic	telepÃ¡tica
guaranteeing	garantizando
rubles	rublos
cmos	cmos
rogaland	rogaland
kwang	kwang
tibor	tibor
tireless	incansables
tireless	incansable
limpopo	limpopo
tandy	tandy
orgasm	orgasmo
orgasm	orgasmos
carbonyl	carbonilo
kenilworth	kenilworth
fumes	humos
stepson	hijastro
shikoku	shikoku
fuente	fuente
cystic	quÃ­stica
toads	sapos
virtus	virtus
sportsnet	sportsnet
ramiro	ramiro
vaz	vaz
wellcome	wellcome
realisation	realizaciÃ³n
jacek	jacek
paypal	paypal
joystick	joystick
crickets	grillos
triathletes	triatletas
kwai	kwai
lÃ©ger	lÃ©ger
evers	evers
dma	dma
vodacom	vodacom
wolfowitz	wolfowitz
mfk	mfk
mss	mss
fluorine	flÃºor
linnean	linneana
birdman	birdman
amenable	susceptible
rodger	rodger
backstreet	backstreet
terr	terr
kernels	nÃºcleos
hargreaves	hargreaves
redhawks	redhawks
gravestone	lÃ¡pida
tps	tps
hennepin	hennepin
arduous	arduo
arduous	ardua
aab	aab
interns	internos
interns	becarios
interns	pasantes
cordero	cordero
tipu	tipu
niklas	niklas
conspiracies	conspiraciones
navigators	navegantes
navigators	navegadores
kilpatrick	kilpatrick
giza	giza
infestation	infestaciÃ³n
wisÅ‚a	wisÅ‚a
houdini	houdini
neglecting	descuidar
skanderbeg	skanderbeg
lumley	lumley
opengl	opengl
avenged	vengado
segmentation	segmentaciÃ³n
mila	mila
inman	inman
phenol	fenol
erlangen	erlangen
sentinels	centinelas
shekhar	shekhar
palaiologos	paleÃ³logo
rtv	rtv
audits	auditorÃ­as
chipset	chipset
emissary	emisario
narcissus	narciso
epithelium	epitelio
pfizer	pfizer
vinny	vinny
rescuers	rescatistas
sportivo	sportivo
scathing	mordaz
sheboygan	sheboygan
artistically	artÃ­sticamente
cranbrook	cranbrook
toba	toba
generously	generosamente
yule	yule
plateaus	mesetas
ashfield	ashfield
sedentary	sedentarios
mohun	mohun
lifeguard	salvavidas
gazprom	gazprom
wbo	wbo
tetsuya	tetsuya
mimicking	imitando
platoons	pelotones
govinda	govinda
ecozone	ecozona
norrkÃ¶ping	norrkÃ¶ping
wicks	mechas
wicks	wicks
bahr	bahr
chimera	quimera
edd	edd
guardianship	tutela
pharmacies	farmacias
neotropical	neotropicales
vertebral	vertebral
neurotransmitter	neurotransmisor
lice	piojos
bihari	bihari
emc	emc
iodide	yoduro
szabÃ³	szabÃ³
inflorescences	inflorescencias
silicone	silicona
eiji	eiji
antichrist	anticristo
perthshire	perthshire
likud	likud
huggins	huggins
hom	hom
szeged	szeged
heathcote	heathcote
draco	draco
annandale	annandale
donatello	donatello
hells	infiernos
catenary	catenaria
filings	limaduras
allergies	alergia
allergies	alergias
woodworking	carpinterÃ­a
sotomayor	sotomayor
katana	katana
amicable	amistosa
amicable	amistoso
heber	heber
ewald	ewald
lifeline	salvavidas
communicative	comunicativo
oyly	oyly
typhoons	tifones
nagel	nagel
denim	denim
glotto	glotto
bambi	bambi
peripherals	perifÃ©ricos
peripherals	perifÃ©rico
impediment	impedimento
bulawayo	bulawayo
fondly	cariÃ±osamente
pym	pym
cyberpunk	cyberpunk
wirth	wirth
gautama	gautama
wps	wps
recombinant	recombinante
kasper	kasper
kangxi	kangxi
mussel	mejillones
errant	errante
eisteddfod	eisteddfod
palos	palos
azarenka	azarenka
pda	pda
biophys	biophys
getafe	getafe
biofuels	biocarburantes
biofuels	biocombustibles
vitaly	vitaly
payback	venganza
nella	nella
geocentric	geocÃ©ntrico
lennie	lennie
taunting	burla
taunting	burlas
methamphetamine	metanfetamina
methamphetamine	metanfetaminas
huai	huai
woodley	woodley
sme	sme
sme	pyme
sme	pymes
tiago	tiago
vilas	vilas
farman	farman
sela	sela
bartoli	bartoli
plasmodium	plasmodium
pres	pres
reimbursement	reembolso
chandos	chandos
rotors	rotores
whitehorse	whitehorse
bayside	bayside
trudy	trudy
roundup	roundup
roundup	redada
ominous	siniestro
rehearsing	ensayando
chirac	chirac
aker	aker
herpes	herpes
sveriges	sveriges
nilsen	nilsen
bettina	bettina
valverde	valverde
outtakes	outtakes
chievo	chievo
yannick	yannick
adjectival	adjetival
irradiation	irradiaciÃ³n
amputated	amputado
giselle	giselle
aeg	aeg
scopus	scopus
vividly	vÃ­vidamente
kilburn	kilburn
groÃŸ	groÃŸ
darkened	oscureciÃ³
minuteman	minuteman
mcloughlin	mcloughlin
morehouse	morehouse
metabolite	metabolito
thorell	thorell
trainings	entrenamientos
vibrating	vibrar
vibrating	vibra
vibrating	vibrante
dufferin	dufferin
tricia	tricia
lymphocytes	linfocitos
hyena	hiena
sloboda	sloboda
cheadle	cheadle
prefabricated	prefabricados
prefabricated	prefabricadas
steffen	steffen
mourners	dolientes
darwinism	darwinismo
veszprÃ©m	veszprÃ©m
gagnon	gagnon
wea	wea
falsehood	falsedad
rosenfeld	rosenfeld
leiber	leiber
resonator	resonador
warmed	calentado
determinants	determinantes
lathe	torno
tiwari	tiwari
canard	canard
powerlifting	powerlifting
metroplex	metroplex
skoda	skoda
gorton	gorton
xxv	xxv
sopron	sopron
pennetta	pennetta
sharpened	afilado
cockerell	cockerell
angell	angell
doubting	dudar
doubting	dudando
macs	macs
tulu	tulu
spinach	espinacas
spinach	espinaca
yasmin	yasmin
mcnabb	mcnabb
viana	viana
hausdorff	hausdorff
modestly	modestamente
madigan	madigan
snk	snk
mulhouse	mulhouse
fergusson	fergusson
assimilate	asimilar
erasure	erasure
erasure	borrado
terrance	terrance
snoopy	snoopy
byproduct	subproducto
tilings	teselados
springtime	primavera
satÅ	satÅ
pseudoscientific	pseudocientÃ­fico
kendo	kendo
marianna	marianna
damir	damir
duh	duh
yukio	yukio
biscayne	biscayne
chrissie	chrissie
maryam	maryam
tithes	diezmos
tenacity	tenacidad
mcmullen	mcmullen
rubiaceae	rubiaceae
silverware	cubiertos
symbiosis	simbiosis
ibid	ibÃ­d
spyware	spyware
vernal	vernal
sandberg	sandberg
lesnar	lesnar
earrings	aretes
earrings	aros
earrings	pendientes
lacroix	lacroix
polymorphism	polimorfismo
deviant	desviado
prov	prov
materially	materialmente
wormhole	agujero
amasya	amasya
rupp	rupp
incision	incisiÃ³n
oxfam	oxfam
ecologically	ecolÃ³gicamente
schltr	schltr
biao	biao
macdougall	macdougall
vial	vial
mfc	mfc
codecs	codecs
laserdisc	laserdisc
cockatoo	cacatÃºa
defensible	defendible
jogging	correr
guano	guano
thematically	temÃ¡ticamente
priyanka	priyanka
honorius	honorio
thackeray	thackeray
leduc	leduc
monocoque	monocasco
Ä‘á»“ng	Ä‘á»“ng
edgbaston	edgbaston
miri	miri
marg	marg
howes	howes
whiskers	bigotes
fortis	fortis
thang	thang
oxnard	oxnard
slovaks	eslovacos
capote	capote
cady	cady
gondwana	gondwana
inflected	flexiva
puntland	puntlandia
tisdale	tisdale
adderley	adderley
mrc	mrc
kruse	kruse
courtyards	patios
azimuth	acimut
blasters	blasters
trowbridge	trowbridge
lobsters	langosta
lobsters	langostas
vivienne	vivienne
ronstadt	ronstadt
newlands	newlands
pigott	pigott
verdasco	verdasco
petitioner	demandante
petitioner	peticionario
muisca	muisca
yamazaki	yamazaki
lactose	lactosa
pipers	gaiteros
orestes	orestes
govind	govind
sameer	sameer
jaco	jaco
knowle	knowle
icp	pci
icp	pic
emporis	emporis
quicktime	quicktime
siedlce	siedlce
wielkie	wielkie
guaranÃ­	guaranÃ­
aileen	aileen
godolphin	godolphin
interwoven	entrelazadas
escherichia	escherichia
goblet	cÃ¡liz
midge	midge
drÃ´me	drÃ´me
accumulates	acumula
ballymena	ballymena
nazaire	nazaire
kkk	kkk
webbed	palmeados
bcc	bre
bcc	bcc
buchenwald	buchenwald
shiro	shiro
clijsters	clijsters
subvert	subvertir
elland	elland
ccr	ccr
acker	acker
phonetically	fonÃ©ticamente
prospectus	prospecto
prizren	prizren
torturing	torturando
torturing	torturar
magsaysay	magsaysay
norad	norad
bihor	bihor
wer	wer
galli	galli
injustices	injusticias
decadence	decadencia
moffett	moffett
detain	detienen
pastiche	pastiche
kleiner	kleiner
shifter	cambiaformas
pauls	pauls
couplets	coplas
tamer	tamer
mercator	mercator
bathe	baÃ±arse
lanceolate	lanceoladas
csiro	csiro
elblÄ…g	elblÄ…g
karoo	karoo
gish	gish
ketone	cetona
schlegel	schlegel
shard	fragmento
boulevards	bulevares
ahom	ahom
hak	hak
orlov	orlov
wilhelmshaven	wilhelmshaven
reichsbahn	reichsbahn
aamir	aamir
bulkhead	mamparo
protester	manifestante
uil	uil
mehr	mehr
bicarbonate	bicarbonato
pastries	pastas
pastries	pasteles
pastries	reposterÃ­a
skeet	skeet
sinestro	sinestro
langham	langham
ucr	ucr
newborns	neonatos
percussionists	percusionistas
brac	brac
roslyn	roslyn
stratosphere	estratosfera
hamper	cesto
hamper	obstaculizar
hamper	cesta
pompous	pomposo
gaeta	gaeta
slattery	slattery
sdtv	sdtv
fitzhugh	fitzhugh
kolb	kolb
gamut	gama
telstar	telstar
armen	armen
chronically	crÃ³nicamente
percentile	percentil
bosley	bosley
pon	pon
sanfrecce	sanfrecce
overcast	nublado
tetrahedron	tetraedro
transgression	transgresiÃ³n
protectionist	proteccionista
protectionist	proteccionistas
protectionist	proteccionismo
incited	incitado
incited	incitÃ³
hellboy	hellboy
asaph	asaph
charcot	charcot
sidecar	sidecar
kingstown	kingstown
bremerhaven	bremerhaven
unintelligible	incomprensible
unintelligible	ininteligible
csn	csn
semarang	semarang
pil	pil
traviata	traviata
safed	safed
brockton	brockton
weizmann	weizmann
messe	messe
janson	janson
cyrano	cyrano
automorphism	automorfismo
dost	dost
clearfield	clearfield
monomer	monÃ³mero
ragas	ragas
foramen	foramen
nabisco	nabisco
krÃ¼ger	krÃ¼ger
xerxes	jerjes
preliminaries	preliminares
argeÈ™	argeÈ™
improvise	improvisar
wiccan	wiccan
meow	miau
kashgar	kashgar
noda	noda
alten	alten
diallo	diallo
wahid	wahid
borghese	borghese
schenk	schenk
oars	remos
madly	locamente
damme	damme
bisexuality	bisexualidad
kimchi	kimchi
attentive	atento
attentive	atentos
attentive	atenta
ainslie	ainslie
bodo	bodo
hermon	hermon
isolde	isolda
jerÃ³nimo	jerÃ³nimo
chrysostom	crisÃ³stomo
sabu	sabu
dateline	dateline
tortures	torturas
prater	prater
delacroix	delacroix
arecibo	arecibo
sopot	sopot
crotalus	crotalus
marvellous	maravilloso
marvellous	maravillosa
subterminal	subterminal
tuscarora	tuscarora
workspace	workspace
satori	satori
impaled	empalado
uday	uday
bollocks	cojones
denman	denman
wilford	wilford
scuderia	scuderia
prisms	prismas
retirees	jubilados
mariko	mariko
hoot	hoot
moshav	moshav
clementi	clementi
ramanujan	ramanujan
verden	verden
edf	fed
edf	edf
kargil	kargil
ignacy	ignacy
dayal	dayal
vought	vought
cowie	cowie
liquefied	licuado
valse	valse
vysoÄina	vysoÄina
merciless	despiadada
merciless	despiadados
merciless	despiadado
chocolates	chocolates
chocolates	bombones
garrido	garrido
expedite	acelerar
expedite	agilizar
eames	eames
semyon	semyon
shaver	shaver
dejean	dejean
cng	gnc
khans	kanes
intrusions	intrusiones
selig	selig
maneuverability	maniobrabilidad
gordo	gordo
cling	aferrarse
cozy	acogedor
cozy	acogedora
riddick	riddick
pseudomonas	pseudomonas
albee	albee
cheesy	cursi
awoke	despertÃ©
awoke	despertÃ³
awoke	despertaron
watertight	estancos
daugava	daugava
rcc	rcc
warts	verrugas
jobim	jobim
hab	hab
dorÃ©	dorÃ©
fae	fae
palembang	palembang
imperatore	imperatore
taboos	tabÃº
taboos	tabÃºes
gargoyle	gÃ¡rgola
kshatriya	kshatriya
tethered	atados
tethered	atado
mÃ³nica	mÃ³nica
karolina	karolina
messer	messer
holi	holi
fertilized	fertilizados
reassure	tranquilizar
morgen	morgen
econometrics	econometrÃ­a
zinn	zinn
laughton	laughton
hoses	mangueras
relativism	relativismo
jujuy	jujuy
considerate	considerada
considerate	considerado
dominus	dominus
shapur	sapor
scifi	scifi
ack	ack
sankara	sankara
tvr	tvr
orel	orel
blondes	rubios
blondes	rubias
bolan	bolan
bernardi	bernardi
sherri	sherri
lamia	lamia
directx	directx
tes	tes
yazid	yazid
fara	fara
Ã¡lava	Ã¡lava
predominance	predominio
passable	pasable
neruda	neruda
bcl	bcl
cancellations	cancelaciones
dedicates	dedica
crammed	hacinados
ciro	ciro
sikorski	sikorski
instituting	instituir
frÃ©mont	frÃ©mont
cobbled	empedradas
daggett	daggett
arta	arta
captivating	cautivadora
freshness	frescura
chamois	gamuza
digitization	digitalizaciÃ³n
stolle	stolle
manas	manas
stadtbahn	stadtbahn
haka	haka
daisies	margaritas
amygdala	amÃ­gdala
fricke	fricke
lak	lak
franky	franky
concordance	concordancia
grazed	rozÃ³
tÅkaidÅ	tÅkaidÅ
boni	boni
reaves	reaves
havok	havok
escondido	escondido
ennobled	ennoblecido
daud	daud
ellipsis	elipsis
creuse	creuse
adrianople	adrianÃ³polis
ostia	ostia
tsuyoshi	tsuyoshi
tubman	tubman
auster	auster
imperfections	imperfecciones
slingshot	honda
hindley	hindley
halberstadt	halberstadt
lilo	lilo
iida	iida
wendel	wendel
baran	baran
carpentier	carpentier
nusa	nusa
rackets	raquetas
princeps	princeps
chorzÃ³w	chorzÃ³w
theistic	teÃ­sta
saheb	saheb
ventilated	ventiladas
bren	bren
narcissism	narcisismo
devito	devito
cort	cort
megafauna	megafauna
moksha	moksha
impressionists	impresionistas
handouts	limosnas
unspoken	tÃ¡cito
overpopulation	superpoblaciÃ³n
glarus	glaris
asaf	asaf
adored	adorado
adored	adoraba
adored	adorada
tannery	curtidurÃ­a
Ã¥lesund	Ã¥lesund
cetinje	cetinje
herbicides	herbicidas
cellpadding	cellpadding
elizondo	elizondo
brecker	brecker
fundy	fundy
pichilemu	pichilemu
breathless	breathless
chÃ¢tillon	chÃ¢tillon
expendable	prescindible
fandango	fandango
maxx	maxx
reade	reade
carola	carola
ourense	ourense
caveman	cavernÃ­cola
perdue	perdue
hasharon	hasharon
dvr	dvr
gec	gec
mishaps	contratiempos
cutlery	cubiertos
malang	malang
curatorial	curatorial
montauban	montauban
resold	revendido
bolshevism	bolchevismo
peshwa	peshwa
hurriedly	apresuradamente
darken	oscurecer
manoel	manoel
wilhelmine	guillermina
bewildered	desconcertado
jeffers	jeffers
omicron	omicron
weigel	weigel
rebuke	reproche
rebuke	reprimenda
refrigerators	frigorÃ­ficos
refrigerators	refrigeradores
acceptability	aceptabilidad
arianna	arianna
moskva	moskva
reconstructive	reconstructiva
densetsu	densetsu
mvs	mvs
shusha	shusha
neptunes	neptunes
labors	labores
emmaus	emaÃºs
enrÃ­quez	enrÃ­quez
urchins	erizos
quimby	quimby
liepÄja	liepÄja
glick	glick
ogun	ogun
inÃ¶nÃ¼	inÃ¶nÃ¼
bellow	bellow
edsel	edsel
houser	houser
atpase	atpasa
payson	payson
arborea	arborea
screwdriver	destornillador
equidistant	equidistantes
krefeld	krefeld
hingham	hingham
piezoelectric	piezoelÃ©ctricos
bidwell	bidwell
covariant	covariante
lynyrd	lynyrd
korolev	korolev
behr	behr
plesetsk	plesetsk
nahin	nahin
skagit	skagit
softening	ablandamiento
dismissals	despidos
albarn	albarn
stings	picaduras
hoppe	hoppe
rheinland	rheinland
asr	asr
beaverton	beaverton
teja	teja
rowena	rowena
backwater	remanso
applet	applet
gpp	gpp
dictatorships	dictaduras
specializations	especializaciones
coria	coria
grindcore	grindcore
urbanisation	urbanizaciÃ³n
crofton	crofton
kunal	kunal
grills	parrillas
thÃ©ophile	thÃ©ophile
moorings	amarres
moorings	amarre
moorings	amarras
turco	turco
macklin	macklin
etymologically	etimolÃ³gicamente
aguayo	aguayo
feinberg	feinberg
wheelwright	wheelwright
brittain	brittain
ethiopians	etÃ­opes
sauropod	saurÃ³podo
channeling	canalizar
channeling	canalizaciÃ³n
channeling	canalizando
intensifies	intensifican
intensifies	intensifica
xuÃ¢n	xuÃ¢n
sayaka	sayaka
middelburg	middelburg
stieglitz	stieglitz
bunt	bunt
josefina	josefina
marshmallow	malvavisco
marshmallow	malvaviscos
federative	federativa
zonguldak	zonguldak
molla	molla
instinctive	instintiva
veliki	veliki
buttercup	buttercup
harrah	harrah
culprits	culpables
quilts	colchas
karp	karp
freikorps	freikorps
abia	abia
necklaces	collares
foxtrot	foxtrot
tupi	tupi
banshees	banshees
smedley	smedley
brak	brak
bogdanov	bogdanov
hdl	hdl
ogc	ogc
rhyl	rhyl
rogÃ©rio	rogÃ©rio
cobblestone	adoquÃ­n
winemaker	enÃ³logo
geldof	geldof
banka	banka
paulin	paulin
creeds	credos
countesses	condesas
koen	koen
mauve	malva
horny	caliente
horny	cÃ³rnea
horny	cachondo
wird	wird
hoshino	hoshino
nbr	nbr
vier	vier
nanette	nanette
dwarfism	enanismo
asano	asano
hughie	hughie
lubavitch	lubavitch
jago	jago
edgware	edgware
coloma	coloma
merion	merion
mckeon	mckeon
ojibwa	ojibwa
misogyny	misoginia
demir	demir
pearlman	pearlman
hadron	hadrones
hos	hos
burnette	burnette
ratner	ratner
foretold	predijo
foretold	anunciada
foretold	predicho
blinking	parpadeo
hod	hod
feisty	luchadora
keokuk	keokuk
misrepresents	tergiversa
bagram	bagram
kumara	kumara
kalat	kalat
ricks	ricks
enna	enna
fath	fath
belive	creer
raff	raff
monotheism	monoteÃ­smo
septimius	septimio
smes	pyme
smes	pymes
dalziel	dalziel
merckx	merckx
bazooka	bazooka
perceptive	perceptivo
strangle	estrangular
gaslight	gaslight
physiotherapist	fisioterapeuta
saros	saros
dnepr	dnepr
roni	roni
ferrÃ©	ferrÃ©
lewd	lascivo
switzer	switzer
forex	forex
forex	divisas
ferri	ferri
exacerbate	exacerbar
goma	goma
ingushetia	ingushetia
menorah	menorah
tali	tali
jÃ³nsson	jÃ³nsson
conditioner	acondicionador
elin	elin
davila	davila
mulla	mulla
fantagraphics	fantagraphics
chemie	chemie
roby	roby
ayaka	ayaka
magruder	magruder
schwarzkopf	schwarzkopf
zimbru	zimbru
primers	primers
paÃ§os	paÃ§os
lingam	lingam
erb	erb
myeloma	mieloma
messner	messner
leyla	leyla
hirano	hirano
rÃ¡kÃ³czi	rÃ¡kÃ³czi
dez	dez
diatribe	diatriba
ilves	ilves
reflectors	reflectores
mccourt	mccourt
fulford	fulford
magritte	magritte
remoteness	lejanÃ­a
kutaisi	kutaisi
verband	verband
spinosa	spinosa
sonne	sonne
mcluhan	mcluhan
troilus	troilo
landskrona	landskrona
phobias	fobias
ossie	ossie
nowitzki	nowitzki
erg	erg
zaza	zaza
deceptively	engaÃ±osamente
nape	nuca
cormorants	cormoranes
jacobo	jacobo
terrors	terrores
natur	natur
clanton	clanton
wct	wct
wholesaler	mayorista
wholesaler	mayoristas
lamm	lamm
renan	renan
gere	gere
lanchester	lanchester
molise	molise
zagÅ‚Ä™bie	zagÅ‚Ä™bie
ezequiel	ezequiel
pinal	pinal
pandemonium	pandemonium
dej	dej
irradiated	irradiados
schÃ¼ttler	schÃ¼ttler
manifestly	manifiestamente
grete	grete
ldl	ldl
rudolstadt	rudolstadt
reactivation	reactivaciÃ³n
khimik	khimik
shakin	shakin
poltergeist	poltergeist
benham	benham
suvs	suv
haystack	pajar
lomÃ©	lomÃ©
mailman	cartero
torr	torr
ere	ere
rosettes	rosetas
lca	clp
chubb	chubb
koine	koinÃ©
macartney	macartney
hamamatsu	hamamatsu
opc	opc
mechanistic	mecanicista
takara	takara
nobuo	nobuo
behrend	behrend
eic	eic
chairlift	telesilla
daan	daan
dima	dima
zant	zant
spool	bobina
jacobin	jacobino
rosenblatt	rosenblatt
reassuring	tranquilizador
reassuring	tranquilizar
bron	bron
vandross	vandross
aspinall	aspinall
dav	dav
blackbirds	mirlos
millville	millville
wetmore	wetmore
mankiewicz	mankiewicz
lebrun	lebrun
kym	kym
gastroenterology	gastroenterologÃ­a
dakotas	dakotas
schorr	schorr
valjean	valjean
pariah	paria
sabc	sabc
burghley	burghley
ilhan	ilhan
manfredi	manfredi
glossaries	glosarios
santini	santini
aigle	aigle
transpose	transposiciÃ³n
transpose	transponer
drunkard	borracho
outkast	outkast
cranium	crÃ¡neo
indisputably	indiscutiblemente
sÃ¡enz	sÃ¡enz
wisniewski	wisniewski
wnbc	wnbc
melodi	melodi
darkening	oscurecimiento
ventilator	ventilador
ventilator	respirador
retiro	retiro
psychopathology	psicopatologÃ­a
ganda	ganda
instigating	instigaciÃ³n
instigating	instigar
maclaine	maclaine
jel	jel
bille	bille
urethra	uretra
proboscis	probÃ³scide
malleable	maleable
marcelle	marcelle
swank	swank
swank	ostentoso
trucker	camionero
jacksons	jacksons
taleb	taleb
tweedy	tweedy
banish	desterrar
aed	aed
seismology	sismologÃ­a
ashburn	ashburn
incisive	incisiva
witney	witney
joana	joana
godin	godin
makino	makino
naturalis	naturalis
railhawks	railhawks
clift	clift
weilburg	weilburg
ubiquity	ubicuidad
gla	gla
nicolay	nicolay
cuza	cuza
buries	entierra
nifl	nifl
carbines	carabinas
scylla	scylla
canova	canova
polygraph	polÃ­grafo
viasat	viasat
expansionist	expansionista
lumpkin	lumpkin
keelung	keelung
quicksand	quicksand
aragorn	aragorn
russellville	russellville
raeder	raeder
cyrene	cirene
mcallen	mcallen
bardo	bardo
retirements	jubilaciones
bahman	bahman
tcg	tcg
dynamism	dinamismo
sirte	sirte
regionalist	regionalista
enders	enders
photonic	fotÃ³nico
katÅ	katÅ
colourless	incoloro
colourless	incolora
merz	merz
stol	stol
gabashvili	gabashvili
tabari	tabari
daum	daum
cuernavaca	cuernavaca
parkman	parkman
zanuck	zanuck
egy	egy
friedl	friedl
sliema	sliema
coves	calas
flavescens	flavescens
militare	militare
fett	fett
ciarÃ¡n	ciarÃ¡n
hofstadter	hofstadter
hato	hato
yaqui	yaqui
pyke	pyke
lanzarote	lanzarote
notaries	notarios
notaries	notario
lsa	lsa
folklorists	folcloristas
beria	beria
niamey	niamey
gulbis	gulbis
khutor	jÃºtor
imitates	imita
enhancer	potenciador
enosis	enosis
electrolytes	electrolitos
camcorder	videocÃ¡mara
tinamou	tinamidae
shivers	escalofrÃ­os
olle	olle
cranford	cranford
blatt	blatt
escambia	escambia
tepals	tÃ©palos
arapahoe	arapahoe
pollux	pollux
sanctified	santificado
keitel	keitel
Å›lÄ…skie	Å›lÄ…skie
yoyo	yoyo
couto	couto
snapdragon	snapdragon
melfi	melfi
skinhead	skinhead
rhotic	rÃ³tica
withering	fulminante
extraterrestrials	extraterrestres
nant	nant
moffitt	moffitt
separations	separaciones
bayernliga	bayernliga
hardcastle	hardcastle
eaa	eaa
eaa	cea
sonatina	sonatina
Ã©milie	Ã©milie
instigate	instigar
tgf	tgf
aci	aci
sverige	sverige
bruch	bruch
samarra	samarra
mendy	mendy
pegu	pegu
casson	casson
goldin	goldin
hirundo	hirundo
tpc	tpc
chileans	chilenos
theologically	teolÃ³gicamente
chÃ­	chÃ­
subtleties	sutilezas
wilander	wilander
pinacoteca	pinacoteca
gagged	amordazado
unterhaching	unterhaching
aÃ¯n	aÃ¯n
smriti	smriti
fid	fid
parnassus	parnassus
tati	tati
laetitia	laetitia
historische	historische
bellum	bellum
allegra	allegra
amÃ©dÃ©e	amÃ©dÃ©e
khali	khali
chamonix	chamonix
sdl	sdl
chert	chert
figueres	figueres
unforgiven	unforgiven
verdon	verdon
oya	oya
antonelli	antonelli
kufa	kufa
theroux	theroux
vÃ¤rmland	vÃ¤rmland
cres	cres
pansy	pansy
argonaut	argonaut
Åta	Åta
heliocentric	heliocÃ©ntrico
guttenberg	guttenberg
personalised	personalizada
personalised	personalizado
akwa	akwa
defections	deserciones
maslow	maslow
reddick	reddick
danner	danner
bonelli	bonelli
fwd	fwd
kofu	kofu
kÃ¶then	kÃ¶then
sintra	sintra
rivaled	rivalizaba
galesburg	galesburg
bourdon	bourdon
manne	manne
semicircle	semicÃ­rculo
lerma	lerma
libris	libris
josepha	josepha
brachiopods	braquiÃ³podos
viti	viti
gaspÃ©	gaspesia
gakkai	gakkai
carlile	carlile
rasta	rasta
leann	leann
bores	aburren
bores	aburre
bores	aburridos
evaporates	evapora
thiessen	thiessen
absolutepunk	absolutepunk
ambiance	ambiente
asf	asf
georgescu	georgescu
impatience	impaciencia
aras	aras
implicating	implicando
pozo	pozo
ammons	ammons
jÃ¸rn	jÃ¸rn
dsv	dsv
dabbled	incursionÃ³
kodama	kodama
isf	isf
materialise	materializarse
ppa	cce
ppa	ppa
ovals	Ã³valos
ebsco	ebsco
saudis	sauditas
saudis	saudÃ­es
impotent	impotentes
impotent	impotente
inchon	inchon
dishwasher	lavaplatos
dishwasher	lavavajillas
ibu	ibu
bootcamp	bootcamp
fainting	desmayarse
fainting	desmayos
fainting	desmayo
mikheil	mikheil
beauce	beauce
rÃªve	rÃªve
brunson	brunson
unsortable	unsortable
squawk	graznido
amiri	amiri
regurgitation	regurgitaciÃ³n
prawns	langostinos
prawns	gambas
myrrh	mirra
skÃ«nderbeu	skÃ«nderbeu
eurosceptic	euroescÃ©ptico
agitator	agitador
insularis	insularis
duiker	duiker
hermine	hermine
distorts	distorsiona
lande	lande
morÃ³n	morÃ³n
placeholders	comodines
argentina}}	argentina}}
mansfeld	mansfeld
dioecious	dioica
handicaps	desventajas
imperia	imperia
steinbrenner	steinbrenner
cerrito	cerrito
usu	usu
amand	amand
tipsareviÄ‡	tipsareviÄ‡
hibiki	hibiki
wdm	wdm
bootsy	bootsy
moyÃ¡	moyÃ¡
herero	herero
polyhedral	poliÃ©drica
masud	masud
milian	milian
poynter	poynter
bindu	bindu
tanna	tanna
bickerton	bickerton
druk	druk
stinks	apesta
farben	farben
mingle	mezclarse
ahs	ahs
sphincter	esfÃ­nter
takei	takei
neopaganism	neopaganismo
badass	rudo
incinerator	incineraciÃ³n
cobo	cobo
kozani	kozani
cpusa	cpusa
palanka	palanka
henna	henna
mouscron	mouscron
anaya	anaya
mondial	mondial
earache	earache
frugal	frugal
ginkgo	ginkgo
tzvi	tzvi
lefÃ¨vre	lefÃ¨vre
prakrit	prÃ¡crito
artin	artin
thalberg	thalberg
logger	leÃ±ador
quiver	carcaj
bromfield	bromfield
birney	birney
dudu	dudu
prideaux	prideaux
takoma	takoma
aurich	aurich
choreographic	coreogrÃ¡fica
holodomor	holodomor
roches	roches
beamer	beamer
hmc	hmc
soderbergh	soderbergh
hyperbola	hipÃ©rbola
lycos	lycos
helgi	helgi
gerhart	gerhart
ucs	ucs
trimmer	trimmer
reinach	reinach