revamped	remaniÃ©
revamped	rÃ©organisÃ©
gaze	regard
albright	albright
lucerne	luzerne
lucerne	lucerne
conquering	conquÃ©rant
conquering	conquÃ©rir
nbsp	nbsp
ageing	vieillir
ageing	vieillissement
knopf	knopf
sonnets	sonnets
avi	avi
fugue	fugue
hoboken	hoboken
barbie	barbie
konami	konami
stooges	stooges
supervise	superviser
supervise	supervise
inducing	induire
spindle	broche
spindle	fuseau
ossetia	ossÃ©tie
aiken	aiken
edmunds	edmunds
baseless	infondÃ©es
ganges	gange
lair	lair
lair	taniÃ¨re
lair	repaire
figueroa	figueroa
kml	kml
greta	greta
interacted	interagi
bluffs	bluffs
milner	milner
cyclops	cyclope
mcclure	mcclure
recoil	recul
pneumatic	pneumatique
pneumatic	pneumatiques
msu	msu
convocation	convocation
kaiserslautern	kaiserslautern
seinfeld	seinfeld
noodles	nouilles
ahmet	ahmet
arad	arad
figaro	figaro
pasta	pÃ¢tes
retina	rÃ©tine
stardust	stardust
zoran	zoran
eliminates	Ã©limine
bakr	bakr
fundamentalist	fondamentaliste
fundamentalist	fondamentalisme
fundamentalist	intÃ©gristes
fundamentalist	fondamentalistes
yap	yap
gabriele	gabriele
stair	escalier
rockin	rockin
dis	dis
delft	delft
spiny	Ã©pineuse
spiny	Ã©pineuses
spiny	Ã©pineux
aroused	suscitÃ©
upanishad	upanishad
johnstown	johnstown
embroidery	broderie
embroidery	broderies
etruscan	Ã©trusque
geiger	geiger
moser	moser
erratic	erratique
ritz	ritz
dll	dll
tambourine	tambourin
jug	cruche
jug	pichet
brentwood	brentwood
ananda	ananda
landscaping	terrassement
landscaping	paysagiste
landscaping	amÃ©nagement
bro	bro
bro	frangin
bro	frÃ©rot
extraordinarily	extraordinairement
monorail	monorail
granny	mÃ©mÃ©
granny	mamie
bianchi	bianchi
dives	plongÃ©es
sss	sss
recognises	reconnait
recognises	reconnaÃ®t
goode	goode
nineties	nineties
replicated	reproduit
anemia	anÃ©mie
ypres	ypres
finns	finlandais
extremity	extrÃ©mitÃ©
yehuda	yehuda
neapolitan	napolitaine
buffaloes	buffles
goliath	goliath
analysed	analysÃ©
analysed	analysÃ©es
analysed	analysÃ©s
furlong	furlong
gaetano	gaetano
freiherr	freiherr
cpa	cpa
brutus	brutus
hollyoaks	hollyoaks
flop	flop
nÃºÃ±ez	nÃºÃ±ez
nkvd	nkvd
discriminate	discriminer
adil	adil
eugenia	eugenia
amish	amish
zeal	zÃ¨le
belvedere	belvedere
belvedere	belvÃ©dÃ¨re
fireman	pompier
jayne	jayne
lancelot	lancelot
twists	tord
twists	torsions
corbin	corbin
peaches	pÃªches
unjustified	injustifiÃ©es
unjustified	injustifiÃ©
unjustified	injustifiÃ©e
thebes	thÃ¨bes
lorna	lorna
koenig	koenig
hochschule	hochschule
kandy	kandy
nizam	nizam
hiro	hiro
salam	salam
rudi	rudi
allman	allman
larval	larvaire
larval	larve
crocodiles	crocodiles
sumter	sumter
essentials	essentiels
essentials	essentielles
essentials	essentiel
colossal	colossal
colossal	colossale
lms	lms
petro	petro
fruitful	fructueux
fruitful	fructueuse
fruitful	fÃ©cond
fruitful	fructueuses
bradman	bradman
goodnight	bonsoir
abilene	abilene
footprints	empreintes
ust	oust
skirmishes	accrochages
skirmishes	escarmouches
gilman	gilman
experimentally	expÃ©rimentalement
invoking	invoquer
invoking	invoquant
brahman	brahman
footbridge	passerelle
bamberg	bamberg
agony	agonie
descartes	descartes
ohl	ohl
corrective	correcteur
corrective	correcteurs
corrective	correctif
corrective	correctives
escuela	escuela
rioting	Ã©meute
rioting	Ã©meutes
hsbc	hsbc
sita	sita
castleford	castleford
ramona	ramona
jax	jax
watergate	watergate
cairn	cairn
tra	tra
moira	moira
incubator	incubateurs
incubator	incubateur
incubator	pÃ©piniÃ¨re
outback	outback
sedgwick	sedgwick
wiseman	wiseman
vaulted	voÃ»tÃ©e
scottsdale	scottsdale
unreal	irrÃ©el
transistors	transistors
bunkers	bunkers
bunkers	soutes
contradictions	contradictions
whl	whl
ormond	ormond
demolish	dÃ©molir
morten	morten
sacrificing	sacrifier
aoc	aoc
rocking	bascule
udp	udp
mcfarlane	mcfarlane
artie	artie
restores	restaurations
restores	restaure
restores	rÃ©tablit
necropolis	nÃ©cropole
banja	banja
colossus	colosse
sultans	sultans
bouchard	bouchard
omni	omni
recife	recife
addendum	addendum
addendum	additif
primus	primus
inequalities	inÃ©galitÃ©s
halsey	halsey
prudent	prudente
prudent	prudentes
prudent	prudent
prudent	prudents
trailed	traÃ®nÃ©
fugitives	fugitifs
installments	versements
corvettes	corvettes
compassionate	compassion
compassionate	compatissant
arjuna	arjuna
housekeeper	gouvernante
ute	ute
cagayan	cagayan
uwe	uwe
blackwater	blackwater
hutchins	hutchins
bbs	bbs
ounces	onces
sully	sully
geometrical	gÃ©omÃ©trique
pino	pino
binder	classeur
binder	liant
binder	cartable
spar	spar
richness	richesse
guanajuato	guanajuato
pickups	camionnettes
beasley	beasley
magically	magiquement
lager	lager
jÃ¸rgen	jÃ¸rgen
bachchan	bachchan
promontory	promontoire
shenyang	shenyang
everlasting	eternel
everlasting	Ã©ternels
everlasting	Ã©ternelle
everlasting	Ã©ternel
attachÃ©	attachÃ©e
attachÃ©	attachÃ©
arafat	arafat
jelena	jelena
correa	correa
folsom	folsom
cyp	cyp
relapse	rechute
seÃ±ora	seÃ±ora
porous	poreux
porous	poreuse
bogart	bogart
argos	argos
setbacks	reculs
hackers	pirates
hackers	hackers
estrogen	Å“strogÃ¨nes
brabham	brabham
revising	rÃ©visant
groin	aine
remorse	remords
fashions	modes
xiu	xiu
pressurized	pressurisÃ©e
bluish	bleuÃ¢tre
prohibitions	interdictions
bowes	bowes
tumour	tumeurs
tumour	tumeur
notary	notaire
notary	notaires
udinese	udinese
primacy	primautÃ©
cmg	cmg
mansell	mansell
cern	cern
eradicate	Ã©radiquer
eradicate	Ã©radication
biologically	biologiquement
philly	philadelphie
philly	philly
mela	mela
ostrava	ostrava
hodder	hodder
ophthalmology	ophtalmologie
pussy	minou
pussy	pussy
pussy	chatte
pussy	chattes
plebiscite	plÃ©biscite
pranks	farces
bubba	bubba
beggars	mendiants
facelift	lifting
envoys	envoyÃ©s
envoys	Ã©missaires
griswold	griswold
donahue	donahue
sludge	boues
sludge	boue
privatisation	privatisations
privatisation	privatisation
tikva	tikva
tarragona	tarragone
tomsk	tomsk
mods	mods
heilongjiang	heilongjiang
satb	satb
favours	favorise
favours	faveurs
coyne	coyne
sakhalin	sakhaline
schaus	schaus
jodie	jodie
nome	nome
thumbs	pouces
thumbs	pouce
ubc	ubc
valparaiso	valparaiso
dobbs	dobbs
loir	loir
jozef	jozef
miloÅ¡eviÄ‡	miloÅ¡eviÄ‡
magenta	magenta
glitch	pÃ©pin
glitch	glitch
curia	curie
stillwater	stillwater
absorbs	absorbe
publius	publius
hippo	hippo
hippo	hippopotame
sutcliffe	sutcliffe
palmeiras	palmeiras
tpb	tpb
womb	utÃ©rus
voltages	tensions
obituaries	nÃ©crologies
obituaries	nÃ©crologie
minions	serviteurs
minions	sbires
minions	minions
mchale	mchale
mol	mol
hanlon	hanlon
grainger	grainger
parable	parabole
curtains	rideau
curtains	rideaux
nanda	nanda
buckle	boucle
donoghue	donoghue
gre	gre
potion	potion
veer	veer
hinge	charniÃ¨re
hinge	charniÃ¨res
mujer	mujer
cle	cle
realty	realty
languedoc	languedoc
dismantling	dÃ©montage
dismantling	dÃ©mantÃ¨lement
dismantling	dÃ©manteler
interlocking	enclenchement
interlocking	imbriquÃ©es
polishing	polir
polishing	polissage
yvette	yvette
tories	tories
authorizing	autorisant
lexus	lexus
manche	manche
cre	cre
banter	plaisanteries
ranches	ranchs
valera	valera
ainsworth	ainsworth
edn	edn
resettled	rÃ©installÃ©s
stool	tabouret
gorky	gorky
rzeszÃ³w	rzeszÃ³w
ise	ise
orf	orf
constitutionally	constitutionnellement
esteghlal	esteghlal
deerfield	deerfield
symbolizing	symbolisant
aspire	aspire
aspire	aspirent
aspire	aspirer
lanier	lanier
hemlock	hemlock
coop	coop
rios	rios
confrontations	confrontations
confrontations	affrontements
Ã¶rebro	Ã¶rebro
erode	Ã©roder
flammable	inflammable
flammable	inflammables
veterinarian	vÃ©tÃ©rinaire
solano	solano
martens	martens
rockville	rockville
misdemeanor	dÃ©lit
mugabe	mugabe
ade	ade
negation	nÃ©gation
cuff	manchette
gwent	gwent
busby	busby
azhar	azhar
ucc	ucc
adrenaline	adrÃ©naline
cearÃ¡	cearÃ¡
pinot	pinot
supersport	supersport
rawlings	rawlings
applicability	applicabilitÃ©
buckner	buckner
amused	amusÃ©e
amused	amusÃ©s
amused	amusÃ©
barbosa	barbosa
goguryeo	goguryeo
fujita	fujita
casually	nÃ©gligemment
comstock	comstock
gli	gli
waka	waka
whispers	murmure
whispers	murmures
kongo	kongo
memes	memes
excitation	excitation
charlottetown	charlottetown
lira	lires
lira	lira
druid	druide
decency	dÃ©cence
sod	sod
sod	gazon
donne	donne
dentists	dentistes
williamsport	williamsport
hatched	Ã©clos
morristown	morristown
talon	talon
flipping	renversant
burgers	burgers
burgers	hamburgers
vistula	vistule
zoltÃ¡n	zoltÃ¡n
schott	schott
cultivating	cultiver
cthulhu	cthulhu
ingestion	ingestion
tus	tus
horus	horus
runes	runes
mites	mites
mites	acariens
monteiro	monteiro
braÈ™ov	braÈ™ov
uniÃ£o	uniÃ£o
ilam	ilam
rolle	rolle
astrakhan	astrakhan
srb	srb
leviathan	lÃ©viathan
unter	unter
blasted	fichue
geary	geary
gai	gai
coniferous	conifÃ¨res
coniferous	rÃ©sineux
wulf	wulf
sanborn	sanborn
inflicting	infligeant
inflicting	infliger
kootenay	kootenay
emmet	emmet
sucking	sucer
cartman	cartman
foyer	foyer
bookshop	librairie
stiffness	raideur
stiffness	rigiditÃ©
padova	padoue
brookline	brookline
yost	yost
unlv	unlv
stressing	stresser
stressing	soulignant
stressing	insistant
cla	cia
lizzy	lizzy
maneuvering	manÅ“uvre
olimpija	olimpija
kush	kush
reusable	rÃ©utilisables
reusable	rÃ©utilisable
teo	teo
morte	morte
ell	ell
complements	complÃ©ments
skates	patins
brevard	brevard
roskilde	roskilde
radiating	rayonnant
hustler	arnaqueur
hustler	hustler
bowery	bowery
routers	routeurs
juanita	juanita
ftc	ftc
gauthier	gauthier
rÃ¤ikkÃ¶nen	rÃ¤ikkÃ¶nen
europaea	europaea
angoulÃªme	angoulÃªme
esmeralda	esmeralda
polygons	polygones
centering	centrage
schweitzer	schweitzer
bodywork	carrosserie
takers	preneurs
louvain	louvain
melchior	melchior
innumerable	innombrables
genÃ¨ve	genÃ¨ve
kyu	kyu
rsfsr	rsfsr
odeon	odeon
lapsed	caduc
lapsed	caduque
ferocious	fÃ©roce
ferocious	fÃ©roces
destitute	dÃ©munis
destitute	indigents
navarra	navarre
lowery	lowery
terrapins	terrapins
beret	bÃ©ret
beret	beret
phan	phan
spartanburg	spartanburg
waldemar	waldemar
inexperience	inexpÃ©rience
divisione	divisione
hin	hin
dalmatian	dalmatien
almagro	almagro
lavinia	lavinia
bionic	bionique
supercomputer	superordinateur
ansi	ansi
thessaly	thessalie
tiki	tiki
mandi	mandi
corvus	corvus
morel	morel
ssh	ssh
harwich	harwich
fukui	fukui
unworthy	indigne
unworthy	indignes
utensils	ustensiles
intruders	intrus
nah	nah
nah	nan
bjÃ¸rn	bjÃ¸rn
marÃ­n	marÃ­n
acrobatic	acrobatique
tic	tic
laila	laila
norwegians	norvÃ©giens
shoshone	shoshone
neri	neri
bullion	lingot
bullion	lingots
dvoÅ™Ã¡k	dvoÅ™Ã¡k
cowper	cowper
paradigms	paradigmes
bran	bran
monsanto	monsanto
pasco	pasco
lse	lse
juventud	juventud
standish	standish
margherita	margherita
caucuses	caucus
rar	rar
sufficiency	suffisance
leaflet	dÃ©pliant
conwy	conwy
gorham	gorham
#in	#en
#in	#dans
#in	#Ã 
mobilize	mobiliser
mobilize	mobilisent
nene	nene
underhill	underhill
vasile	vasile
sprints	sprints
tÃ¼rk	tÃ¼rk
thrillers	thrillers
ploy	stratagÃ¨me
spacex	spacex
ghazal	ghazal
salta	salta
anemone	anÃ©mone
camillo	camillo
barrows	barrows
sanz	sanz
opportunistic	opportuniste
opportunistic	opportunistes
ingested	ingÃ©rÃ©
cir	cir
alvaro	Ã¡lvaro
alvaro	alvaro
excesses	excÃ¨s
bearcats	bearcats
exclamation	exclamation
shatner	shatner
maranhÃ£o	maranhÃ£o
dorn	dorn
amigos	amigos
netscape	netscape
nagai	nagai
figs	figues
ita}}	ita}}
vladikavkaz	vladikavkaz
piss	pisser
piss	pisse
heretics	hÃ©rÃ©tiques
damm	damm
faisalabad	faisalabad
feline	fÃ©lin
feline	fÃ©line
symonds	symonds
sunnyside	sunnyside
ucd	ucd
orca	orca
acetic	acÃ©tique
importer	importateurs
importer	importateur
pharaohs	pharaons
cygnus	cygnus
pelletier	pelletier
bovine	bovine
bovine	bovin
manoeuvre	manoeuvre
manoeuvre	manÅ“uvrer
manoeuvre	manÅ“uvre
hilaire	hilaire
allium	allium
hombre	hombre
bourg	bourg
monkees	monkees
busters	busters
rubles	roubles
botched	bÃ¢clÃ©
mpc	ppm
hinges	charniÃ¨re
hinges	charniÃ¨res
shahi	shahi
desoto	desoto
stavropol	stavropol
brito	brito
delusions	illusions
delusions	dÃ©lires
roadblock	barrage
contagious	contagieuse
contagious	contagieux
contagious	contagieuses
feliciano	feliciano
warringah	warringah
shp	shp
angkor	angkor
pangasinan	pangasinan
pups	chiots
spezia	spezia
koko	koko
alcalde	alcalde
sweetness	douceur
hackensack	hackensack
coiled	enroulÃ©
rucker	rucker
cosgrove	cosgrove
jna	jna
jayhawks	jayhawks
beauties	beautÃ©s
approximations	approximations
powerpc	powerpc
gutted	vidÃ©
dominick	dominick
hetman	hetman
elms	elms
cardoso	cardoso
evers	evers
mobil	mobil
orozco	orozco
stabilizer	stabilisateur
stabilizer	stabilisateurs
stabilizer	stabilisant
wilfried	wilfried
footballdatabase	footballdatabase
schaeffer	schaeffer
fabrice	fabrice
ldp	pld
ldp	ldp
spiked	corsÃ©
borrowers	emprunteurs
abbaye	abbaye
ruc	ruc
costas	costas
rena	rena
ismael	ismaÃ«l
ismael	ismael
droughts	sÃ©cheresses
droughts	sÃ©cheresse
gaba	gaba
spires	spires
kittens	chatons
gamerankings	gamerankings
brier	brier
dolce	dolce
femur	fÃ©mur
eines	eines
sentinels	sentinelles
antonius	antonius
ostend	ostende
psd	dsp
plow	charrue
underprivileged	dÃ©favorisÃ©s
underprivileged	dÃ©favorisÃ©
idw	idw
slay	assassiner
slay	massacrer
slay	tuer
seduced	sÃ©duite
seduced	sÃ©duits
seduced	sÃ©duit
rohit	rohit
pfizer	pfizer
barnstaple	barnstaple
chrono	chrono
playmates	playmates
leveling	nivellement
tinto	tinto
watermelon	pastÃ¨que
watermelon	pastÃ¨ques
mcs	mcs
earmarked	affectÃ©es
hormonal	hormonale
hormonal	hormonal
hormonal	hormonaux
snider	snider
mohamad	mohamad
intensification	intensification
intensification	intensifier
bourgogne	bourgogne
accented	accentuÃ©
accented	accentuÃ©s
accented	accentuÃ©e
accented	accentuÃ©es
ariana	ariana
cormac	cormac
macomb	macomb
biloxi	biloxi
diodes	diodes
twister	tornade
twister	twister
wicks	mÃ¨ches
mako	mako
gearing	engrenage
adriÃ¡n	adriÃ¡n
cataract	cataracte
grahame	grahame
sportsmanship	sportivitÃ©
grampus	grampus
ehud	ehud
mistral	mistral
mouton	mouton
outages	pannes
monteverdi	monteverdi
brazos	brazos
suceava	suceava
galapagos	galapagos
modifier	modificateur
shank	shank
shank	jarret
glorified	glorifiÃ©
automate	automatiser
raffaele	raffaele
monolith	monolithe
xtra	xtra
cypriots	chypriotes
ando	ando
blume	blume
muldoon	muldoon
sistema	sistema
bÃ¡rbara	bÃ¡rbara
bustamante	bustamante
undermines	sape
swede	suÃ©dois
daemon	dÃ©mon
callers	appelants
leto	leto
datta	datta
bolzano	bolzano
flintshire	flintshire
galÃ¡pagos	galÃ¡pagos
peep	peep
accomplices	complices
rood	rood
symmetries	symÃ©tries
scratched	rayÃ©
bou	bou
kandi	kandi
authorisation	autorisation
chiswick	chiswick
quarto	quarto
heathen	paÃ¯en
heathen	paÃ¯ens
kyoko	kyoko
dahomey	dahomey
dissolves	dissout
sens	sens
dissipation	dissipation
ingeborg	ingeborg
usman	usman
fondly	affectueusement
tydfil	tydfil
gallardo	gallardo
carpathians	carpates
clausen	clausen
shunting	manÅ“uvre
shunting	manÅ“uvres
dubstep	dubstep
ach	ach
baptista	baptista
syrians	syriens
torrential	torrentielles
purging	purge
purging	purger
kangxi	kangxi
gutter	gouttiÃ¨re
gutter	caniveau
aligning	alignement
opossum	opossum
spoleto	spoleto
glaser	glaser
cranberry	canneberges
cranberry	canneberge
mooring	amarrage
stuffing	rembourrage
stuffing	farce
converging	convergentes
converging	converger
converging	convergent
stretcher	civiÃ¨re
stretcher	brancard
thirsty	assoiffÃ©
thirsty	assoiffÃ©s
thirsty	soif
marinos	marinos
mummies	momies
pepys	pepys
precipitate	prÃ©cipitÃ©
demille	demille
gts	gts
purvis	purvis
corroborated	corroborÃ©
corroborated	corroborer
corroborated	corroborÃ©e
hyder	hyder
affinities	affinitÃ©s
kommune	kommune
bucknell	bucknell
reimbursement	remboursement
reimbursement	remboursements
enforceable	exÃ©cutoire
enforceable	exÃ©cutoires
aer	aer
kona	kona
vonnegut	vonnegut
dermatitis	dermatite
suvorov	souvorov
perilous	pÃ©rilleuse
perilous	pÃ©rilleux
shred	once
shred	dÃ©chiqueter
shred	broyer
antagonism	antagonisme
misha	misha
indent	indentation
indent	tiret
grievance	grief
grievance	griefs
gallus	gallus
saha	saha
kinsella	kinsella
tfl	tfl
voluminous	volumineuses
voluminous	volumineux
yannick	yannick
monson	monson
mathura	mathura
joys	joies
hunedoara	hunedoara
bivalve	bivalves
amboy	amboy
hitchens	hitchens
pulsar	pulsar
angelus	angelus
carrÃ©	carrÃ©
compliments	compliments
wolseley	wolseley
contraceptive	contraceptifs
contraceptive	contraception
manet	manet
dpp	dpp
tuzla	tuzla
mistresses	maÃ®tresses
perturbation	perturbation
garrard	garrard
trickster	trickster
alisa	alisa
asante	asante
macrophages	macrophages
lymphocytes	lymphocytes
inspectorate	inspection
ktm	ktm
kinases	kinases
stoves	cuisiniÃ¨res
stoves	poÃªles
edelman	edelman
deathly	mortellement
enumeration	dÃ©nombrement
enumeration	Ã©numÃ©ration
proportionally	proportionnellement
flagg	flagg
iww	iww
boulenger	boulenger
chuang	chuang
mitterrand	mitterrand
hexagon	hexagone
montauk	montauk
pog	pog
barracuda	barracuda
suitors	prÃ©tendants
tetra	tetra
tulu	tulu
intelligentsia	intelligentsia
corte	corte
andriy	andriy
tinsley	tinsley
zdf	zdf
muammar	mouammar
macao	macao
bletchley	bletchley
calico	calico
tsa	tsa
shakers	shakers
boney	boney
ludacris	ludacris
forfeiture	confiscation
kremer	kremer
pinellas	pinellas
whoops	oups
neves	neves
lessing	lessing
ponting	ponting
imageshack	imageshack
dfl	dfl
ozzie	ozzie
datu	datu
wma	wma
wma	amm
tasha	tasha
marianna	marianna
converged	convergent
larisa	larisa
epoxy	Ã©poxy
reminders	rappels
evict	expulser
croton	croton
muncie	muncie
loughlin	loughlin
dimaggio	dimaggio
bleachers	gradins
cargill	cargill
meagher	meagher
endicott	endicott
helsingborg	helsingborg
#you	#tu
#you	#you
stratum	strate
stratum	strates
alphanumeric	alphanumÃ©riques
alphanumeric	alphanumÃ©rique
abn	abn
boxurl	boxurl
cautiously	prudemment
brodsky	brodsky
pacquiao	pacquiao
materially	matÃ©riellement
luxembourgish	luxembourgeois
luxembourgish	luxembourgeoise
bunyan	bunyan
uga	uga
griffon	griffon
simba	simba
choking	Ã©touffement
schltr	schltr
dialectic	dialectique
serpents	serpents
mores	mÅ“urs
cÃ©line	cÃ©line
mephisto	mephisto
indentation	indentation
lindisfarne	lindisfarne
portability	portabilitÃ©
gwynn	gwynn
tristar	tristar
introspective	introspective
tsinghua	tsinghua
murfreesboro	murfreesboro
babyface	babyface
sacristy	sacristie
candlelight	chandelles
braden	braden
antimony	antimoine
dipper	ourse
weevil	weevil
sancti	sancti
balthasar	balthasar
eminently	Ã©minemment
lockyer	lockyer
oxnard	oxnard
redefine	redÃ©finir
greensburg	greensburg
camponotus	camponotus
sacco	sacco
dynamos	dynamos
seiji	seiji
novÃ¡k	novÃ¡k
tisdale	tisdale
oas	oea
oas	sv
mrc	mrc
ioannina	ioannina
kruse	kruse
pimlico	pimlico
hollins	hollins
cartels	cartels
cartels	ententes
trowbridge	trowbridge
undeniably	indÃ©niablement
undeniably	incontestablement
alabaster	albÃ¢tre
nakagawa	nakagawa
tiverton	tiverton
rinaldo	rinaldo
schÃ¤fer	schÃ¤fer
donut	donut
donut	beignet
piranha	piranha
fatwa	fatwa
daze	daze
chlorophyll	chlorophylle
intolerant	intolÃ©rants
lukÃ¡Å¡	lukÃ¡Å¡
navi	navi
incessant	incessante
incessant	incessantes
incessant	incessants
incessant	incessant
zigzag	zigzag
roseville	roseville
steinway	steinway
grierson	grierson
faw	faw
akan	akan
quayle	quayle
gyeongsang	gyeongsang
schaffer	schaffer
nazaire	nazaire
biswas	biswas
returner	returner
ankles	chevilles
cÃ©cile	cÃ©cile
morey	morey
simona	simona
whiteley	whiteley
isham	isham
objectors	objecteurs
pontefract	pontefract
picardie	picardie
sheeran	sheeran
pettit	pettit
greenwald	greenwald
ricard	ricard
offa	offa
nar	nar
mbar	mbar
evoking	Ã©voquant
henriksen	henriksen
saÃ«ns	saÃ«ns
meher	meher
libertas	libertas
smurfs	schtroumpfs
middleware	middleware
bothwell	bothwell
surgically	chirurgicalement
occ	occ
taito	taito
hing	hing
sla	sla
sla	als
aro	aro
invents	invente
diffused	diffus
diffused	diffuse
bhi	bhi
panics	paniques
aharon	aharon
migraine	migraine
migraine	migraines
mami	mami
mejÃ­a	mejÃ­a
cyclical	cyclique
cyclical	cycliques
xanthi	xanthi
dementieva	dementieva
alfaro	alfaro
crowder	crowder
tanja	tanja
humbly	humblement
sochaux	sochaux
knuth	knuth
cot	berceau
cot	cot
alanis	alanis
sani	sani
shampoo	shampoing
shampoo	shampooing
beavis	beavis
denali	denali
cri	cri
kristiania	kristiania
fogarty	fogarty
mehr	mehr
gabonese	gabonaise
gabonese	gabonais
skimming	Ã©crÃ©mage
allenby	allenby
impregnated	imprÃ©gnÃ©s
impregnated	imprÃ©gnÃ©e
impregnated	imprÃ©gnÃ©es
impregnated	imprÃ©gnÃ©
machina	machina
sofÃ­a	sofÃ­a
lass	lass
lÃ¡zaro	lÃ¡zaro
bana	bana
plagues	flÃ©aux
birgit	birgit
diverging	divergentes
diverging	divergente
diverging	divergent
macaque	macaque
sayre	sayre
mycobacterium	mycobacterium
yon	yon
fives	fives
rit	rit
literatur	literatur
horgan	horgan
bullseye	bullseye
nabil	nabil
mtb	vtt
rcs	rcs
heriot	heriot
sanfrecce	sanfrecce
gilpin	gilpin
gaiety	gaietÃ©
civ	civ
hÃ©rcules	hÃ©rcules
gentrification	gentrification
catwalk	passerelle
imsa	imsa
liaisons	liaisons
horan	horan
glazer	glazer
semarang	semarang
cosenza	cosenza
isl	isl
lalo	lalo
brockton	brockton
weizmann	weizmann
barham	barham
corus	corus
mech	mech
fictions	fictions
preliminaries	prÃ©liminaires
cecily	cecily
castleton	castleton
accelerates	accÃ©lÃ¨re
tahrir	tahrir
amines	amines
karsten	karsten
machi	machi
payer	payeur
skateboarder	skateboarder
hermosa	hermosa
glockenspiel	glockenspiel
escalator	escalator
fairport	fairport
kul	kul
ldu	ldu
laurentian	laurentides
laurentian	laurentienne
sapienza	sapienza
doggett	doggett
ruan	ruan
kamp	kamp
podlaska	podlaska
capacitive	capacitive
rappahannock	rappahannock
edirne	edirne
sweetened	sucrÃ©s
baia	baia
zor	zor
timon	timon
savona	savone
deleterious	dÃ©lÃ©tÃ¨res
hsin	hsin
grammophon	grammophon
ignace	ignace
hager	hager
rhee	rhee
ess	sse
ess	ess
amado	amado
tiffin	tiffin
sultana	sultana
hallucination	hallucinations
hallucination	hallucination
moni	moni
jayson	jayson
winwood	winwood
orgy	orgie
rutter	rutter
gnomes	nains
gnomes	gnomes
tris	tris
lir	lir
veliko	veliko
rushden	rushden
bingen	bingen
ethers	Ã©thers
rasht	rasht
penning	penning
dfa	dfa
congruence	congruence
nemanja	nemanja
bayeux	bayeux
lope	lope
aurea	aurea
veloso	veloso
merciless	impitoyable
merciless	impitoyables
merciless	impitoyablement
haydon	haydon
belediyespor	belediyespor
endocrinology	endocrinologie
nona	nona
cabeza	cabeza
collett	collett
shareware	shareware
whining	pleurnicher
triads	triades
torsten	torsten
cng	gnc
saws	scies
cooperates	coopÃ¨re
vangelis	vangelis
concordat	concordat
jemima	jemima
wied	wied
jackals	chacals
zucker	zucker
pathos	pathos
sequencer	sÃ©quenceur
dhawan	dhawan
eventful	mouvementÃ©
eventful	mouvementÃ©e
pattaya	pattaya
dorÃ©	dorÃ©
subpoena	assignation
komatsu	komatsu
noa	noa
utricularia	utricularia
mame	mame
na+	na+
arthurs	arthurs
aleph	aleph
emt	ambulancier
roa	roa
oxbow	oxbow
grinstead	grinstead
zinn	zinn
tapia	tapia
romer	romer
nitin	nitin
atrocity	atrocitÃ©
atrocity	atrocitÃ©s
solberg	solberg
prohibitive	prohibitifs
prohibitive	prohibitif
hunch	intuition
hunch	pressentiment
impersonate	incarner
impersonate	imiter
dreamland	dreamland
moti	moti
insecticide	insecticide
synods	synodes
tseng	tseng
emmylou	emmylou
motels	motels
pacer	pacer
mingo	mingo
frauen	frauen
conquers	conquiert
svein	svein
squatting	accroupi
squatting	squatter
riser	riser
pata	pata
ciro	ciro
blister	blister
blister	plaquette
dispel	dissiper
dmz	dmz
posada	posada
futura	futura
fabien	fabien
ouagadougou	ouagadougou
tenchi	tenchi
lafontaine	lafontaine
memos	mÃ©mos
potro	potro
politehnica	politehnica
arginine	arginine
drifters	drifters
unequivocal	Ã©quivoque
unequivocal	univoque
lain	lain
bilingualism	bilinguisme
pathak	pathak
blot	blot
versace	versace
modulator	modulateur
thyme	thym
petitioners	pÃ©titionnaires
hydrological	hydrologique
hydrological	hydrologiques
perelman	perelman
nikÅ¡iÄ‡	nikÅ¡iÄ‡
cann	cann
wendel	wendel
masaryk	masaryk
pagasa	pagasa
butters	butters
glades	glades
mohandas	mohandas
joule	joule
ventilated	aÃ©rÃ©
ventilated	ventilÃ©
ventilated	ventilÃ©e
yousuf	yousuf
wilks	wilks
starke	starke
zou	zou
belafonte	belafonte
disapprove	dÃ©sapprouve
sudetenland	sudÃ¨tes
khas	khas
celso	celso
miramichi	miramichi
ferencvÃ¡ros	ferencvÃ¡ros
vinnytsia	vinnytsia
mccool	mccool
jog	jogging
kaj	kaj
mcevoy	mcevoy
cff	cff
bixby	bixby
decompose	dÃ©composer
lewisburg	lewisburg
breathless	essoufflÃ©
screamed	criÃ©
screamed	hurlÃ©
abstention	abstention
erectus	erectus
trillium	trillium
salivary	salivaires
winchell	winchell
galvanized	galvanisÃ©
mirai	mirai
enderby	enderby
organically	organiquement
stopper	bouchon
deviantart	deviantart
oso	oso
instantaneously	instantanÃ©ment
sÃ¼leyman	sÃ¼leyman
anachronism	anachronisme
anachronism	anachronique
benevolence	bienveillance
civics	civisme
civics	civique
ostrÃ³da	ostrÃ³da
gyroscope	gyroscope
lindstrÃ¶m	lindstrÃ¶m
shuttleworth	shuttleworth
pandya	pandya
maan	maan
strobe	strobe
reysol	reysol
energetically	Ã©nergiquement
tabula	tabula
mandopop	mandopop
materia	materia
soli	soli
kalahari	kalahari
sessile	sessiles
morozov	morozov
grigor	grigor
accumulator	accumulateur
caxton	caxton
refrigerators	rÃ©frigÃ©rateurs
nena	nena
shana	shana
weaves	tisse
westlife	westlife
bade	bade
hassett	hassett
searcy	searcy
boehm	boehm
enrÃ­quez	enrÃ­quez
poi	poi
riki	riki
charlottenburg	charlottenburg
photogenic	photogÃ©nique
borrowings	emprunts
junÃ­n	junÃ­n
deceleration	dÃ©cÃ©lÃ©ration
bellow	bellow
sandalwood	santal
bernabÃ©u	bernabÃ©u
cundinamarca	cundinamarca
grok	grok
malÃ©	malÃ©
flÃ¨che	flÃ¨che
carnal	charnel
headlight	phares
alavÃ©s	alavÃ©s
nalbandian	nalbandian
annapurna	annapurna
gobi	gobi
michelson	michelson
dagbladet	dagbladet
janes	janes
refreshments	rafraÃ®chissements
ibo	ibo
scotti	scotti
toh	toh
vara	vara
drawers	tiroirs
ondo	ondo
helsing	helsing
junko	junko
sibyl	sibyl
gpp	gpp
solemnly	solennellement
outliers	aberrantes
wedges	coins
wedges	cales
bul	bul
kladno	kladno
fluxus	fluxus
chunichi	chunichi
stoddart	stoddart
hannon	hannon
lascelles	lascelles
pleural	pleural
socratic	socratique
gatos	gatos
pierluigi	pierluigi
faithless	infidÃ¨le
brower	brower
wyandotte	wyandotte
junaid	junaid
hondt	hondt
sauropod	sauropode
itm	itm
middelburg	middelburg
apus	apus
toshi	toshi
rimouski	rimouski
tupou	tupou
infamy	infamie
millbrook	millbrook
alk	alk
gamla	gamla
instinctive	instinctivement
instinctive	instinctif
brumbies	brumbies
szabo	szabo
delray	delray
hiromi	hiromi
keirin	keirin
corset	corset
tÃ³th	tÃ³th
rebus	rebus
bessel	bessel
acheson	acheson
tupi	tupi
montbÃ©liard	montbÃ©liard
pickers	cueilleurs
reise	reise
trixie	trixie
knitted	tricot
knitted	bonneterie
victimization	victimisation
kwa	kwa
aliasing	aliasing
corliss	corliss
beveren	beveren
telecaster	telecaster
studia	studia
maersk	maersk
stubbornly	obstinÃ©ment
maliciously	malicieusement
lugosi	lugosi
sniff	sniff
kubo	kubo
grazia	grazia
mythbusters	mythbusters
stradivarius	stradivarius
kowalczyk	kowalczyk
sadhana	sadhana
nostrand	nostrand
bukowski	bukowski
marthe	marthe
reinvestment	rÃ©investissement
reinvestment	rÃ©investir
culvert	ponceau
culvert	caniveau
ragnarok	ragnarok
besa	besa
finkel	finkel
couplings	raccords
ferruccio	ferruccio
daugavpils	daugavpils
ligeti	ligeti
aragua	aragua
myriam	myriam
raonic	raonic
buzzing	bourdonnement
crumble	crumble
lhc	lhc
durkin	durkin
svn	svn
svn	cvs
carell	carell
bande	bande
zoltan	zoltan
wissenschaft	wissenschaft
obadiah	obadiah
pawar	pawar
raff	raff
mittal	mittal
kraken	kraken
deschutes	deschutes
smetana	smetana
sanya	sanya
rudge	rudge
burundian	burundaise
burundian	burundais
snopes	snopes
ghostface	ghostface
mclain	mclain
specialities	spÃ©cialitÃ©s
joh	joh
bogan	bogan
hemiptera	hemiptera
juni	juni
pfister	pfister
vcr	magnÃ©toscope
dentition	dentition
gremlin	gremlin
scottie	scottie
pce	pce
roku	roku
adac	adac
trilobite	trilobite
naresh	naresh
deformities	difformitÃ©s
hinde	hinde
mangal	mangal
bubonic	bubonique
prue	prue
tine	tine
yle	yle
hbf	hbf
rete	rete
piel	piel
trims	mic
basilio	basilio
messner	messner
ofi	aif
ofi	ofi
oruro	oruro
reka	reka
inadequacy	inadÃ©quation
inadequacy	insuffisance
inadequacy	inadaptation
inadequacy	inadÃ©quat
morgenthau	morgenthau
musser	musser
pembina	pembina
lockerbie	lockerbie
diyarbakÄ±r	diyarbakÄ±r
bss	bss
dampier	dampier
dickenson	dickenson
mtu	mtu
vannes	vannes
alagoas	alagoas
goulet	goulet
lordships	seigneuries
identifications	identifications
innovate	innove
innovate	innover
hartnett	hartnett
bulkheads	cloisons
mcluhan	mcluhan
pontchartrain	pontchartrain
landskrona	landskrona
sumitomo	sumitomo
ostrovsky	ostrovsky
sandor	sandor
isonzo	isonzo
usta	usta
galvatron	galvatron
jacobo	jacobo
askari	askari
conjure	conjure
somalis	somaliens
rangpur	rangpur
olivine	olivine
morpheus	morpheus
kopp	kopp
derg	derg
amami	amami
dalits	dalits
alekhine	alekhine
coghlan	coghlan
lauer	lauer
linke	linke
gravure	gravure
desirability	souhaitable
traian	traian
preservative	conservateur
bartsch	bartsch
rpn	rpn
pascagoula	pascagoula
apeldoorn	apeldoorn
hydrodynamic	hydrodynamique
schreiner	schreiner
auc	asc
auc	auc
altamira	altamira
rmc	rmc
wentz	wentz
poltergeist	poltergeist
jugend	jugend
cuttlefish	seiche
emmen	emmen
ranma	ranma
cocky	arrogant
xfm	xfm
awm	awm
shawinigan	shawinigan
fissile	fissile
fissile	fissiles
bijelo	bijelo
cdm	mdp
szÃ©kesfehÃ©rvÃ¡r	szÃ©kesfehÃ©rvÃ¡r
haupt	haupt
vms	vms
sammlung	sammlung
strasberg	strasberg
giffen	giffen
rnc	rnc
lagged	dÃ©calÃ©e
lagged	dÃ©calÃ©
kann	kann
sesto	sesto
printemps	printemps
colons	colons
mauthausen	mauthausen
simca	simca
telephoned	tÃ©lÃ©phonÃ©
levelling	nivellement
maeve	maeve
condiments	condiments
augustÃ³w	augustÃ³w
bullhead	bullhead
dmt	dmt
schweinfurt	schweinfurt
prevost	prevost
meneses	meneses
guanine	guanine
babi	babi
chewed	mÃ¢chÃ©
dawa	dawa
pvda	pvda
alcatel	alcatel
sfl	sfl
fortin	fortin
kimiko	kimiko
nimh	nimh
wiese	wiese
eccellenza	eccellenza
sumy	soumy
crofts	crofts
cressida	cressida
fuqua	fuqua
scarlatti	scarlatti
newhall	newhall
agostini	agostini
mexico}}	mexico}}
mattingly	mattingly
columbiana	columbiana
seltzer	seltzer
vad	vad
modell	modell
helsingborgs	helsingborgs
insignis	insignis
ossian	ossian
sewall	sewall
retiro	retiro
loretto	loretto
zil	zil
drosera	drosera
nigerians	nigÃ©rians
bufo	bufo
robustus	robustus
indomitable	indomptable
estaing	estaing
bowker	bowker
loin	longe
pavloviÄ‡	pavloviÄ‡
sochaczew	sochaczew
banish	bannir
macgyver	macgyver
ghoshal	ghoshal
ntr	ntr
houma	houma
silber	silber
peet	peet
registrars	greffiers
registrars	enregistreurs
cip	cip
railhawks	railhawks
inoculation	inoculation
strangler	Ã©trangleur
bodil	bodil
berrien	berrien
trechus	trechus
pavements	trottoirs
petrolul	petrolul
spacer	spacer
raimundo	raimundo
brega	brega
saviÄ‡	saviÄ‡
castres	castres
wallin	wallin
puÅ‚awy	puÅ‚awy
timeform	timeform
stockholms	stockholms
jair	jair
mÃ¤dchen	mÃ¤dchen
matkowski	matkowski
endymion	endymion
mav	mav
tabari	tabari
roti	roti
saucers	soucoupes
monts	monts
amistad	amistad
cooder	cooder
rhiannon	rhiannon
tsi	sti
tsi	tsi
rocko	rocko
flach	flach
hirose	hirose
hofstadter	hofstadter
spadina	spadina
fuca	fuca
inflationary	inflationnistes
inflationary	inflationniste
jepsen	jepsen
weta	weta
bato	bato
liturgies	liturgies
guia	guia
lofton	lofton
tvp	tvp
enhancer	enhancer
janina	janina
rogier	rogier
andere	andere
tomic	tomic
parfitt	parfitt
rafah	rafah
yoshiko	yoshiko
afshar	afshar
telos	telos
#we	#on
chc	chc
lafleur	lafleur
klerk	klerk
nanning	nanning
caan	caan
mucho	mucho
superettan	superettan
buna	buna
daniil	daniil
kir	kir
sohrab	sohrab
rytas	rytas
disembark	dÃ©barquer
aci	aci
andino	andino
kuki	kuki
kaas	kaas
badal	badal
grado	grado
macauley	macauley
menotti	menotti
agp	agp
wilander	wilander
bartoszyce	bartoszyce
amrit	amrit
stirner	stirner
aerials	antennes
tura	tura
argosy	argosy
buddleja	buddleja
tsuki	tsuki
elson	elson
bgm	bgm
biceps	biceps
anic	anic
atkin	atkin
khali	khali
nds	nds
uist	uist
messines	messines
doren	doren
ager	ager
maggots	asticots
haft	haft
gtv	gtv
uninhabitable	inhabitable
mairie	mairie
hauer	hauer
naturae	naturae
sheamus	sheamus
stikine	stikine
mandan	mandan
cerda	cerda
#yes	#oui
loaves	miches
loaves	pains
extruded	extrudÃ©
devouring	dÃ©vorant
devouring	dÃ©vorer
josepha	josepha
debi	debi
daiichi	daiichi
refocus	recentrer
refocus	recentrage
macerata	macerata
jablonec	jablonec
canseco	canseco
carlile	carlile
choszczno	choszczno
horwitz	horwitz
harries	harries
kaun	kaun
xxxi	xxxi
twh	twh
rueda	rueda
protectionism	protectionnisme
iftikhar	iftikhar
mammadov	mammadov
seldon	seldon
exclusions	exclusions
exclusions	exclusion
doohan	doohan
asf	asf
eyeglasses	lunettes
quesnel	quesnel
paraphrases	paraphrases
monastir	monastir
acqua	acqua
wnbl	wnbl
kodama	kodama
radovan	radovan
symington	symington
vvs	vvs
ottavio	ottavio
golson	golson
ppa	aae
ppa	ppa
grappa	grappa
stuckey	stuckey
impotent	impuissante
impotent	impuissant
mahÃ©	mahÃ©
newhart	newhart
irrevocably	irrÃ©vocablement
Å›wiecie	Å›wiecie
amoral	amoral
branden	branden
decontamination	dÃ©pollution
decontamination	dÃ©contamination
mle	mle
vliet	vliet
pharynx	pharynx
extractive	extractive
worships	vÃ©nÃ¨re
exhibitor	exposants
exhibitor	exposant
bama	bama
perdido	perdido
prawns	crevettes
taney	taney
caputo	caputo
sunt	sunt
akt	akt
accumulations	accumulations
ubi	ubi
manresa	manresa
evolutions	Ã©volutions
alejo	alejo
attilio	attilio
ojai	ojai
cÃ¢mara	cÃ¢mara
communicable	transmissibles
handicaps	handicaps
pauley	pauley
maddux	maddux
consents	consent
beneÅ¡	beneÅ¡
piaseczno	piaseczno
collet	collet
karn	karn
sultry	sensuel
sultry	sensuelle
kooning	kooning
Ã§anakkale	Ã§anakkale
parmentier	parmentier
abatement	abattement
mcas	mcm
svensk	svensk
masud	masud
proudhon	proudhon
slane	slane
parisi	parisi
regenerating	rÃ©gÃ©nÃ©rer
rondeau	rondeau
harwell	harwell
phaeton	phaeton
kokoda	kokoda
lisicki	lisicki
safar	safar
dershowitz	dershowitz
antes	antes
saro	saro
cobo	cobo
klass	klass
funafuti	funafuti
diamante	diamante
jann	jann
unionville	unionville
taishan	taishan
aurore	aurore
glinka	glinka
henna	hennÃ©
anaya	anaya
wreckers	wreckers
sculpt	sculpter
ionesco	ionesco
conny	conny
mogens	mogens
#that	#ce
#that	#que
nanterre	nanterre
chainz	chainz
kÃ¡lmÃ¡n	kÃ¡lmÃ¡n
trashed	saccagÃ©
bromfield	bromfield
anhydride	anhydride
lepus	lepus
jeg	jeg
sentimentality	sentimentalitÃ©
omo	omo
kegan	kegan
bostock	bostock
aurich	aurich
berlocq	berlocq
unia	unia
sellars	sellars
helgi	helgi
flatts	flatts
sneeze	Ã©ternuer
ramses	ramsÃ¨s
cloaked	occultÃ©
tsingtao	tsingtao
durrant	durrant
retard	retardÃ©
retard	attardÃ©
nikkei	nikkei
iredale	iredale
semana	semana
crumbs	miettes
dismemberment	mutilation
dismemberment	dÃ©membrement
aub	aub
stoyanov	stoyanov
campagna	campagna
hamann	hamann
millman	millman
consiglio	consiglio
scrotum	scrotum
theodorus	theodorus
bosanski	bosanski
wagstaff	wagstaff
stutter	bÃ©gaiement
coxon	coxon
wrangell	wrangell
abp	abp
mantell	mantell
algÃ©rie	algÃ©rie
moc	moc
teu	evp
gringo	gringo
beals	beals
gmp	gmp
superheated	surchauffÃ©e
mirabeau	mirabeau
fatherhood	paternitÃ©
inka	inka
santorini	santorin
doig	doig
koÅ‚obrzeg	koÅ‚obrzeg
gregoire	gregoire
wieluÅ„	wieluÅ„
halfdan	halfdan
px}}	px}}
karak	karak
amery	amery
ment	ment
reichert	reichert
fainted	Ã©vanoui
fainted	Ã©vanouie
ayuntamiento	ayuntamiento
tuo	tuo
blainville	blainville
euan	euan
hulst	hulst
ornette	ornette
uerdingen	uerdingen
soulja	soulja
mejia	mejia
microsd	microsd
econ	econ
hÃ¥kon	hÃ¥kon
daniella	daniella
forlag	forlag
viera	viera
capilla	capilla
Ã©ire	Ã©ire
tableware	vaisselle
ryle	ryle
shovels	pelles
mendonÃ§a	mendonÃ§a
bundesbahn	bundesbahn
teletoon	teletoon
berthing	accostage
velha	velha
borys	borys
ausgabe	ausgabe
raheem	raheem
gretsch	gretsch
gratia	gratia
intercom	interphone
massy	massy
salvio	salvio
tanga	tanga
peto	peto
linotype	linotype
yellowhead	yellowhead
mcardle	mcardle
fatehpur	fatehpur
manik	manik
uesac	uesac
pumila	pumila
spiritus	spiritus
almodÃ³var	almodÃ³var
racibÃ³rz	racibÃ³rz
piran	piran
billancourt	billancourt
esr	esr
bradstreet	bradstreet
amadora	amadora
wartburg	wartburg
jaxa	jaxa
orvieto	orvieto
bedell	bedell
kord	kord
metacomet	metacomet
rampal	rampal
kilwinning	kilwinning
odie	odie
dudgeon	dudgeon
markku	markku
belial	belial
ogier	ogier
howitt	howitt
deathstroke	deathstroke
scutari	scutari
kisumu	kisumu
nanotube	nanotube
apostol	apostol
fos	fos
pref	pref
lubelskie	lubelskie
frenzied	frÃ©nÃ©tique
ebden	ebden
werther	werther
nyingma	nyingma
redwall	redwall
netbook	netbook
athanasios	athanasios
kaaba	kaaba
piri	piri
novy	novy
todorov	todorov
pila	pila
curtius	curtius
ots	ots
top}}	top}}
colla	colla
recht	recht
janissaries	janissaires
garman	garman
bruna	bruna
occultation	occultation
wynette	wynette
caird	caird
rabbani	rabbani
commenter	commentateur
primorje	primorje
molnÃ¡r	molnÃ¡r
glenville	glenville
rodina	rodina
murr	murr
oswalt	oswalt
commending	fÃ©licitant
revitalizing	revitaliser
hunza	hunza
fothergill	fothergill
wankel	wankel
verdugo	verdugo
ullevi	ullevi
skelter	skelter
allophones	allophones
urinate	uriner
talas	talas