mythiques	mythical
mythiques	mythic
brunei	brunei
excommunication	excommunication
garland	garland
armoire	wardrobe
armoire	cupboard
armoire	cabinet
ricciardo	ricciardo
schistes	shales
schistes	shale
spinoza	spinoza
rÃ©veiller	awaken
rÃ©veiller	wake
meneurs	leaders
heine	heine
tourbe	peat
harmon	harmon
nivernais	nivernais
prÃ©cipitation	precipitation
sinatra	sinatra
municipio	municipio
archidiacre	archdeacon
vider	empty
massÃ©na	massÃ©na
capo	capo
cristiano	cristiano
priver	deprive
priver	depriving
miraculeuse	miraculous
miraculeuse	miracle
vaguement	vaguely
vaguement	loosely
shelby	shelby
lugo	lugo
donkey	donkey
ponctuation	punctuation
cham	cham
buissons	bushes
buissons	bush
rommel	rommel
romanisation	romanization
piÃ©destal	pedestal
capter	capture
capter	capturing
piÃ©gÃ©	trapped
dÃ©formations	distortions
dÃ©formations	deformations
dÃ©formations	deformation
dÃ©formations	distortion
sismicitÃ©	seismicity
goiÃ¡s	goiÃ¡s
tania	tania
fleurus	fleurus
convection	convection
chÃ¢teaudun	chÃ¢teaudun
femina	femina
cravate	tie
cravate	necktie
tou	tou
laitiers	dairy
optimiste	upbeat
optimiste	optimistic
optimiste	optimism
optimiste	optimist
ergonomie	ergonomics
ergonomie	ergonomic
ergonomie	usability
yankee	yank
yankee	yankee
revendu	resold
sherry	sherry
charlier	charlier
convaincus	convinced
honfleur	honfleur
brody	brody
confisquÃ©s	confiscated
virgil	virgil
ester	ester
fleischer	fleischer
gyÃ¶rgy	gyÃ¶rgy
remords	remorse
consultÃ©s	consulted
membranes	membrane
membranes	membranes
lovecraft	lovecraft
chÃ¨res	expensive
congÃ©s	leave
matti	matti
fonseca	fonseca
duclos	duclos
patiente	patient
soult	soult
moshe	moshe
middlesbrough	middlesbrough
gauguin	gauguin
nidification	nesting
dÃ©tÃ©rioration	deteriorating
dÃ©tÃ©rioration	deteriorated
dÃ©tÃ©rioration	deterioration
dÃ©tÃ©rioration	degradation
ziegler	ziegler
elephant	elephant
rÃ©surgence	resurgence
infinity	infinity
embrun	embrun
belo	belo
jacquot	jacquot
lamothe	lamothe
osÃ©	racy
prÃ©maturÃ©	premature
pÃ©dophilie	paedophilia
kessel	kessel
attÃ©nuer	mitigate
attÃ©nuer	mitigation
attÃ©nuer	mitigating
reproduite	reproduced
premiere	premiere
libreville	libreville
bacs	trays
bacs	ferries
henryk	henryk
hodgson	hodgson
amendes	fined
amendes	fines
shining	shining
hÃ©rÃ©ditaires	hereditary
cosmopolite	cosmopolitan
ichi	ichi
amÃ©liorÃ©s	upgraded
amÃ©liorÃ©s	improved
amÃ©liorÃ©s	enhanced
suspens	suspense
bild	bild
brutes	gross
brutes	brutes
katerina	katerina
saules	willows
garant	guarantor
garant	garant
aviaire	avian
listÃ©	listed
farah	farah
missa	mesa
missa	missa
highland	highland
vapeurs	vapors
vapeurs	vapours
vapeurs	vapor
vapeurs	steam
vapeurs	vapour
critiquant	criticizing
belligÃ©rants	belligerent
belligÃ©rants	belligerents
oculus	oculus
vortex	vortex
vortex	wormhole
nÃ©crologie	obituary
nÃ©crologie	obituaries
sommaires	abstracts
sommaires	summaries
liane	liane
perl	perl
elektra	elektra
kidd	kidd
mailles	mesh
mailles	meshes
oursins	urchins
garni	garni
blackpool	blackpool
juppÃ©	juppÃ©
dfb	dfb
leiria	leiria
cellier	cellier
cellier	cellar
cellier	pantry
cellier	storeroom
malibu	malibu
sensu	sensu
floral	floral
douteuses	questionable
douteuses	dubious
douteuses	doubtful
bayle	bayle
altman	altman
distinguÃ©e	distinguished
colisÃ©e	coliseum
colisÃ©e	colosseum
colisÃ©e	colisÃ©e
clavel	clavel
lamborghini	lamborghini
marck	marck
papeterie	stationery
cdc	coc
cdc	dcc
cdc	cdc
stÃ©riles	sterile
parÃ¡	parÃ¡
xiao	xiao
napier	napier
cÃ¡ceres	cÃ¡ceres
simard	simard
josiane	josiane
cream	cream
changÃ©e	changed
lemaÃ®tre	lemaÃ®tre
assimilÃ©e	assimilated
mentalitÃ©	mentality
mentalitÃ©	mindset
bliss	bliss
molinaro	molinaro
aborigÃ¨ne	aboriginal
indigne	unworthy
indigne	undignified
terriers	terriers
kyÅ«shÅ«	kyÅ«shÅ«
Ã©ligibles	eligible
macÃ©doniens	macedonian
opportun	timely
opaque	opaque
siege	siege
vigoureusement	vigorously
exportÃ©	exported
bolivien	bolivian
hutton	hutton
rÃ©utilisÃ©	reused
hardouin	hardouin
excursion	excursion
excursion	excursions
circ	circ
cuites	cooked
cuites	baked
modernisÃ©	upgraded
modernisÃ©	modernised
modernisÃ©	modernized
hispaniques	hispanic
magnat	mogul
magnat	tycoon
magnat	magnate
poperinge	poperinge
servan	servan
intercepter	intercepting
intercepter	intercept
radioactif	radioactive
frÃ©quentÃ©s	frequented
sap	sap
reforme	reform
constellations	constellations
dÃ©tachÃ©s	detached
dÃ©tachÃ©s	seconded
conversions	conversions
gilmour	gilmour
maude	maude
darryl	darryl
formulÃ©es	formulated
benneteau	benneteau
reflÃ©tant	reflecting
bombarder	bombard
diversifiÃ©	diversified
diversifiÃ©	diverse
nic	nic
nic	nci
divertissements	entertainment
conduisait	drove
dogmatique	dogmatic
hiller	hiller
cep	cep
racer	racer
notte	notte
commanderies	commanderies
impuissance	helplessness
impuissance	impotence
irvin	irvin
cuevas	cuevas
rÃ©ducteur	reducing
hermes	hermes
alkmaar	alkmaar
carcasse	carcase
carcasse	carcass
analytiques	analytical
jarvis	jarvis
germes	sprouts
germes	germ
germes	germs
chiang	chiang
rÃ©plication	replication
compteurs	meters
compteurs	counters
bordures	borders
inceste	incest
kali	kali
pellerin	pellerin
cassie	cassie
Ã©lectrodes	electrode
Ã©lectrodes	electrodes
mÃ©ritÃ©	deserved
mÃ©ritÃ©	earned
berck	berck
jocelyne	jocelyne
hebei	hebei
perturbÃ©e	troubled
perturbÃ©e	disturbed
perturbÃ©e	disrupted
preneur	taker
eriksson	eriksson
ravageurs	pest
ravageurs	pests
villepin	villepin
susanna	susanna
quota	quota
sonja	sonja
marlowe	marlowe
mariusz	mariusz
joystick	joystick
centralisÃ©e	centralised
centralisÃ©e	centralized
faulkner	faulkner
truffe	truffle
truffe	truffles
usinage	machining
manutention	handling
nourris	fed
macaire	macaire
longo	longo
nieminen	nieminen
niÃ±o	niÃ±o
niÃ±o	nino
loulou	lulu
loulou	loulou
jamel	jamel
mcbride	mcbride
junkers	junkers
cheshire	cheshire
minnelli	minnelli
velÃ¡zquez	velÃ¡zquez
promulguÃ©	promulgated
promulguÃ©	enacted
horatio	horatio
imago	imago
inÃ©gale	uneven
inÃ©gale	unequal
snk	snk
shahar	shahar
raymonde	raymonde
prÃ©sentateurs	presenters
sicard	sicard
boots	boots
ultraviolet	uv
ultraviolet	ultraviolet
aminÃ©	amino
allain	allain
tambourin	tambourine
loubet	loubet
memoriam	memoriam
reproducteur	breeder
roca	roca
tempera	tempera
lucile	lucile
shapiro	shapiro
amandes	almonds
amandes	almond
habillÃ©e	dressed
schola	schola
artes	artes
surinam	suriname
surinam	surinam
motorsport	motorsport
prÃ©sumÃ©e	alleged
prÃ©sumÃ©e	presumed
chaco	chaco
sires	sires
confiserie	confectionery
mueller	mueller
lÃ©pine	lÃ©pine
leandro	leandro
asymÃ©triques	asymmetric
asymÃ©triques	asymmetrical
koizumi	koizumi
curaÃ§ao	curaÃ§ao
verrou	lock
verrou	latch
paok	paok
ostrÃ³w	ostrÃ³w
lituaniens	lithuanian
lituaniens	lithuanians
chantait	sang
stora	stora
excrÃ©ments	excrement
excrÃ©ments	scat
excrÃ©ments	feces
excrÃ©ments	faeces
excrÃ©ments	excreta
superiore	superiore
abolir	abolition
abolir	abolish
embryonnaire	embryonic
comparÃ©s	compared
innocente	innocent
pylÃ´nes	masts
pylÃ´nes	pylons
hernÃ¡n	hernÃ¡n
moderato	moderato
escarmouches	skirmishes
dÃ©capitation	beheading
dÃ©capitation	decapitated
surditÃ©	deafness
contaminÃ©	infected
contaminÃ©	contaminated
slide	slide
beaurepaire	beaurepaire
mikel	mikel
gÃ©nÃ©ratrice	generator
matelot	sailor
matelot	seaman
matelot	crewman
dare	dare
arthropodes	arthropods
wojciech	wojciech
pong	pong
ata	ata
hohenlohe	hohenlohe
cabral	cabral
antananarivo	antananarivo
afrikaner	afrikaner
lommel	lommel
rÃ©voltÃ©	revolted
eros	eros
faisable	doable
faisable	feasible
pipeline	pipeline
bruel	bruel
numero	numero
aÃ©ration	vent
aÃ©ration	ventilation
aÃ©ration	aeration
montoya	montoya
coÃ»teuses	costly
rubio	rubio
regretter	regretting
regretter	regret
laroque	laroque
deja	already
garin	garin
hittites	hittites
microbiologie	microbiology
dÃ©bordements	outbursts
dÃ©bordements	overflows
grenadines	grenadines
adda	adda
obispo	obispo
medvedev	medvedev
enfoirÃ©s	bastards
enfoirÃ©s	motherfuckers
enfoirÃ©s	enfoirÃ©s
bic	bic
Ã©picentre	epicentre
Ã©picentre	epicenter
fresno	fresno
cpu	cpu
incitant	inciting
incitant	prompting
schroeder	schroeder
cuits	cooked
johnstone	johnstone
contaminÃ©s	infected
contaminÃ©s	contaminated
lefort	lefort
clarisse	clarisse
bassett	bassett
patras	patras
abaisse	lowers
menzel	menzel
hiroyuki	hiroyuki
dorothea	dorothea
doubleday	doubleday
rapatriÃ©	repatriated
brasilia	brasilia
chek	chek
dÃ©gradÃ©e	degraded
dÃ©gradÃ©e	deteriorated
pixar	pixar
baudoin	baudoin
raffinÃ©	refined
rÃ©git	regulates
rÃ©git	governs
scoop	scoop
mÃ©thyl	methyl
castelo	castelo
sentait	smelled
sentait	smelt
twickenham	twickenham
dels	dels
rÃ©ceptionniste	receptionist
mÃ¡rio	mÃ¡rio
wolfram	wolfram
pluralitÃ©	plurality
fist	fist
Ã©liminÃ©es	eliminated
atrium	atrium
marginaux	marginal
marginaux	misfits
kita	kita
guan	guan
antonius	antonius
chauvet	chauvet
ende	ende
hertfordshire	hertfordshire
barrymore	barrymore
chavannes	chavannes
turbulences	turbulence
gaine	sheath
gaine	girdle
agitÃ©e	turbulent
agitÃ©e	restless
agitÃ©e	agitated
infectieuse	infectious
rejouer	replay
neuro	neuro
Ã©lectrode	electrode
batte	bat
arnaque	scam
calibres	calibres
infectieux	infectious
pritchard	pritchard
hodge	hodge
testÃ©e	tested
conde	conde
bom	bom
nadir	nadir
intercession	intercession
logarithme	logarithm
sclÃ©rose	sclerosis
misanthrope	misanthrope
fitch	fitch
belkacem	belkacem
dubrovnik	dubrovnik
interpol	interpol
transformateurs	transformer
transformateurs	transformers
transformateurs	processors
transformateurs	converters
crs	crs
crs	srf
sanz	sanz
madawaska	madawaska
Ã©crasant	overwhelming
Ã©crasant	crushing
impÃ©ratifs	imperatives
dekker	dekker
khz	khz
boonen	boonen
crichton	crichton
wulf	wulf
ulf	ulf
mÃ³naco	mÃ³naco
tristes	sad
innovante	innovative
dns	dns
soulanges	soulanges
voyous	thugs
voyous	punks
qualitative	qualitative
lehman	lehman
Ã©mane	emanates
catÃ©goriquement	categorically
querrey	querrey
wladimir	wladimir
vallonnÃ©	undulating
athis	athis
brouillons	draft
brouillons	drafts
solubilitÃ©	solubility
sarawak	sarawak
lueur	glow
salvator	salvator
maladroite	clumsy
compliquÃ©es	complicated
chai	chai
debord	debord
spp	spp
larcher	larcher
#ffe	#ffe
annabelle	annabel
annabelle	annabelle
Ã©radication	eradication
Ã©radication	eradicate
huddersfield	huddersfield
deum	deum
phu	phu
gland	acorn
doÃ±a	doÃ±a
margaux	margaux
lothringen	lothringen
puerta	puerta
voyer	voyer
shrek	shrek
rigole	laugh
edvard	edvard
filtrer	filter
lyra	lyra
kemper	kemper
survenant	outlander
barbizon	barbizon
leonhard	leonhard
rouget	rouget
masquÃ©e	hidden
masquÃ©e	masked
lisette	lisette
pozzo	pozzo
mantegna	mantegna
taschereau	taschereau
guignol	guignol
guignol	clown
guignol	joker
olsson	olsson
parentale	parental
hama	hama
pupitre	console
kef	kef
Ã©tonner	amaze
dÃ©guisÃ©e	disguised
harmonium	harmonium
dÃ©tournÃ©e	roundabout
obstÃ©trique	midwifery
obstÃ©trique	obstetric
obstÃ©trique	obstetrics
fentes	slots
fentes	cracks
fentes	slits
majestic	majestic
yamaska	yamaska
invasives	invasive
jeudis	thursdays
gramme	gramme
gramme	gram
krauss	krauss
togolais	togolese
angolais	angolans
angolais	angolan
titi	titi
bagage	baggage
bagage	luggage
prÃ©sÃ©ance	precedence
dÃ©formÃ©	deformed
dÃ©formÃ©	distorted
Ã©pidÃ©miologie	epidemiology
Ã©pidÃ©miologie	epidemiological
reflux	reflux
reflux	ebb
slip	underwear
slip	underpants
slip	briefs
slip	slip
remington	remington
passagÃ¨re	passenger
bardet	bardet
noyelles	noyelles
suze	suze
mortemart	mortemart
henley	henley
guÃ©risseur	healer
gohan	gohan
rivet	rivet
pudeur	modesty
officieusement	unofficially
officieusement	informally
trie	sorts
gargan	gargan
compensÃ©	compensated
mÃ©ndez	mÃ©ndez
mÃ©ndez	mendez
erickson	erickson
juana	juana
vergy	vergy
waldo	waldo
tathiana	tathiana
anja	anja
inutilisable	unusable
inutilisable	useless
infidÃ¨le	infidel
infidÃ¨le	unfaithful
infidÃ¨le	faithless
viana	viana
seiji	seiji
grigor	grigor
ghislaine	ghislaine
zoos	zoos
zoos	zoo
matadors	matadors
alexei	alexei
bizarrement	strangely
bizarrement	oddly
rÃ©silience	resilient
rÃ©silience	resilience
ancestrales	ancestral
tuf	tuf
Å‚Ä™czyca	Å‚Ä™czyca
daredevil	daredevil
toplica	toplica
yorker	yorker
coaching	coaching
sefer	sefer
tecÄƒu	tecÄƒu
conflent	conflent
italiani	italiani
woreda	woreda
omniprÃ©sente	pervasive
omniprÃ©sente	omnipresent
omniprÃ©sente	ubiquitous
erlangen	erlangen
cambrioleur	burglar
harbin	harbin
mÃ©taphores	metaphor
mÃ©taphores	metaphors
rockford	rockford
signifiÃ©	signified
strings	thongs
charpentiers	carpenters
assignÃ©s	assigned
rationalisation	rationalization
rationalisation	rationalisation
rationalisation	streamlining
briquet	lighter
sabin	sabin
hondo	hondo
bruegel	bruegel
clarification	clarifying
clarification	clarification
joon	joon
radiateur	heater
radiateur	radiator
galli	galli
canadensis	canadensis
fernandel	fernandel
lippi	lippi
ventriculaire	ventricular
repentir	repentance
repentir	repent
heerenveen	heerenveen
sokolov	sokolov
aplomb	aplomb
dÃ©compression	decompression
capensis	capensis
pollet	pollet
camilo	camilo
zan	zan
transfer	transfer
dalila	dalila
colby	colby
rancune	grudge
rancune	spite
hue	hue
araneidae	araneidae
impunitÃ©	impunity
mohr	mohr
gourlay	gourlay
anÃ©antie	devastated
anÃ©antie	annihilated
ciblÃ©	targeted
raimon	raimon
juilliard	juilliard
coÃ¯ncident	coincide
olympus	olympus
sharma	sharma
hendaye	hendaye
spvgg	spvgg
individualiste	individualistic
dÃ©serteur	deserter
planchers	floors
planchers	flooring
barret	barret
chouan	chouan
sanglants	gory
rilke	rilke
traumatique	trauma
traumatique	traumatic
pÃ©nalisÃ©	penalised
pÃ©nalisÃ©	penalized
pluralisme	plurality
pluralisme	pluralism
bohr	bohr
arbitrer	referee
arbitrer	arbitrate
felicia	felicia
kÃ¶hler	kÃ¶hler
mujeres	mujeres
survivante	survivor
beauharnois	beauharnois
charny	charny
trÃ©s	very
idriss	idriss
idriss	idris
morat	morat
matÃ©	matÃ©
jovanoviÄ‡	jovanoviÄ‡
unione	unione
tolima	tolima
misaki	misaki
veneto	veneto
cÃ©libat	celibacy
shinjuku	shinjuku
kaa	kaa
perros	perros
venge	avenge
titularisation	tenure
titrage	titration
volontariat	volunteerism
volontariat	volunteering
coulisse	backstage
molÃ©	molÃ©
evgeny	evgeny
zdenÄ›k	zdenÄ›k
kubot	kubot
pellegrini	pellegrini
amundsen	amundsen
ventricule	ventricular
ventricule	ventricle
chÃ¢timents	punishments
rÃ©sines	resins
rÃ©sines	resin
agressives	aggressive
martyn	martyn
awa	awa
rotary	rotary
lucette	lucette
remorqueur	tugboat
remorqueur	tug
improvisations	improvisations
carafa	carafa
saumure	brine
Ã©lastiques	elastic
moma	moma
majoli	majoli
escapade	escapade
escapade	getaway
ute	ute
mischa	mischa
sergi	sergi
gerrard	gerrard
corazÃ³n	corazÃ³n
sacro	sacro
sacro	sacrosanct
bossa	bossa
majestueux	majestic
majestueux	stately
groom	groom
ratifier	ratify
landers	landers
klm	klm
dÃ©tonation	detonation
reggi	reggi
jacobite	jacobite
battaglia	battaglia
prats	prats
inversÃ©es	inverted
compiler	compile
compiler	compiling
galbraith	galbraith
sÃ©quenÃ§age	sequencing
excitÃ©	excited
excitÃ©	horny
bimestriel	bimonthly
rayo	rayo
gouttiÃ¨re	gutter
gouttiÃ¨re	gutters
nussbaum	nussbaum
autos	automobiles
autos	autos
exportateur	exporter
exportateur	exporting
humus	humus
sanremo	sanremo
infligÃ©e	imposed
infligÃ©e	inflicted
kwan	kwan
cisalpine	cisalpine
stÃ©roÃ¯des	steroid
stÃ©roÃ¯des	steroids
syndromes	syndromes
dushevina	dushevina
parrott	parrott
duplication	duplicate
duplication	duplication
duplication	duplicating
manquÃ©e	missed
sÃ©dimentation	sedimentation
polis	polished
polis	polite
polis	polis
freitas	freitas
giorno	giorno
tacoma	tacoma
aalborg	aalborg
adjudication	allotment
genji	genji
edmondson	edmondson
collioure	collioure
stiles	stiles
scandaleux	outrageous
scandaleux	disgraceful
scandaleux	scandalous
polyester	polyester
mayday	mayday
mascarade	masquerade
mascarade	charade
fructose	fructose
prophÃ©tique	prophetic
hammersmith	hammersmith
schweiz	schweiz
toki	toki
yat	yat
prÃ©misses	premise
bibliothÃ©caires	librarians
grimaud	grimaud
corsini	corsini
trÃ©port	trÃ©port
fondus	melted
fondus	molten
salÃ©es	salty
salÃ©es	salted
lynchage	lynching
carences	shortcomings
carences	deficiencies
schmitz	schmitz
dominance	dominance
ramona	ramona
piz	piz
dobson	dobson
seiter	seiter
atsushi	atsushi
falcone	falcone
sophistiquÃ©s	sophisticated
untitled	untitled
miron	miron
pugh	pugh
retravaillÃ©	reworked
saavedra	saavedra
diversifiÃ©es	diversified
bartholomew	bartholomew
embouteillage	bottling
misty	misty
bucher	bucher
olten	olten
chlorhydrique	hydrochloric
ashe	ashe
radiohead	radiohead
vÃ©gÃ©tarien	vegetarian
lizzy	lizzie
lizzy	lizzy
tÃ©r	tÃ©r
vfr	vfr
whitley	whitley
prÃ©dominant	predominant
rapace	rapace
rapace	raptor
mim	mim
habana	habana
rockabilly	rockabilly
dÃ©Ã§ue	disappointed
haÃ¯tiens	haitian
haÃ¯tiens	haitians
ophÃ¼ls	ophÃ¼ls
tarda	tarda
cso	cso
sÃ©rÃ©	sÃ©rÃ©
vieillir	aging
vieillir	ageing
kerouac	kerouac
triforium	triforium
vÃ©suve	vesuvius
alona	alona
irun	irun
bloomfield	bloomfield
#dfffdf	#dfffdf
amplifiÃ©	amplified
xing	xing
hor	hor
cosma	cosma
semper	semper
almodÃ³var	almodÃ³var
coordonnateur	coordinator
manticore	manticore
hiroshige	hiroshige
luciditÃ©	lucidity
luciditÃ©	lucid
jeannie	jeannie
dividendes	dividends
dividendes	dividend
shape	shape
prada	prada
lebeau	lebeau
conceptuelle	conceptual
viseu	viseu
adressage	addressing
badr	badr
mÃ©langÃ©es	blended
consenti	consented
consenti	consensual
trulli	trulli
handicaps	handicap
handicaps	disabilities
handicaps	handicaps
dominici	dominici
carina	carina
skikda	skikda
ayu	ayu
finaliser	finalise
finaliser	finalize
finaliser	finalizing
bibliophiles	bibliophiles
warburg	warburg
litiÃ¨re	litter
yume	yume
avantageuse	advantageous
arti	arti
jagellonne	jagiellonian
incroyablement	amazingly
incroyablement	incredibly
incroyablement	unbelievably
permutations	permutations
fabiola	fabiola
Ã©picÃ©a	spruce
soupÃ§onnÃ©e	suspected
contournÃ©	bypassed
contournÃ©	circumvented
planÃ©tarium	planetarium
niklas	niklas
piast	piast
plantarum	plantarum
tchadien	chadian
tchadien	chad
mclaglen	mclaglen
unisson	unison
lotta	lotta
blondie	blondie
juli	juli
pietra	pietra
weygand	weygand
nicholls	nicholls
prentice	prentice
huss	huss
vimy	vimy
calumet	calumet
nvidia	nvidia
transposer	transpose
imitateur	copycat
novÃ©	novÃ©
minos	minos
sutra	sutra
fortunato	fortunato
susana	susana
grotesques	grotesques
orban	orban
mÃ©diter	meditation
mÃ©diter	meditate
mÃ©diter	meditating
camargo	camargo
tomsk	tomsk
coÃ¯ncider	coincide
froidement	coldly
scriabine	scriabin
orfeo	orfeo
cahuzac	cahuzac
portatif	portable
confesse	confess
makÃ³w	makÃ³w
caÃ¯ques	caicos
kronstadt	kronstadt
dart	dart
yacoub	yacoub
roulements	bearings
roulements	bearing
vau	vau
gouvernent	govern
kakashi	kakashi
monier	monier
pitti	pitti
poulie	pulley
cannibale	cannibal
villacoublay	villacoublay
goldschmidt	goldschmidt
zamalek	zamalek
excentriques	eccentric
cantorum	cantorum
cuiseaux	cuiseaux
broughton	broughton
scieries	sawmills
scieries	sawmill
jansÃ©nistes	jansenists
tachibana	tachibana
masterson	masterson
troc	barter
tonton	tonton
tonton	uncle
hampden	hampden
muay	muay
pillÃ©s	plundered
pillÃ©s	looted
rosalind	rosalind
balancer	swinging
milliardaires	millionaires
milliardaires	billionaires
milliardaires	billionaire
Ã©crou	nut
ralentie	slowed
corral	corral
sarr	sarr
stasi	stasi
rauma	rauma
taha	taha
casserole	pan
casserole	casserole
bakufu	bakufu
mindanao	mindanao
malhonnÃªte	dishonest
orbigny	orbigny
louison	louison
bernanos	bernanos
nox	nox
mackintosh	mackintosh
pÃ©dophile	pedophile
pÃ©dophile	paedophile
hocine	hocine
kilimandjaro	kilimanjaro
minogue	minogue
severino	severino
siri	siri
guernica	guernica
iga	iga
hackers	hackers
anachronique	anachronism
anachronique	anachronistic
helios	helios
suicidaire	suicidal
sierpc	sierpc
haim	haim
hansÃ©atique	hanseatic
secouru	rescued
hurlements	howling
hurlements	yelling
hurlements	screaming
hurlements	screams
hurlements	shrieking
nao	nao
ilona	ilona
aung	aung
apprÃ©hension	apprehension
pleven	pleven
hardin	hardin
barbour	barbour
vail	vail
mÃ©ritait	deserved
compactes	compact
chappuis	chappuis
ronda	ronda
connaught	connaught
druzes	druze
alicja	alicja
falkirk	falkirk
vallecano	vallecano
verges	verges
verges	yards
fedor	fedor
bleeker	bleeker
tromsÃ¸	tromsÃ¸
transatlantiques	transatlantic
baigner	bathe
editrice	editrice
assayas	assayas
thiam	thiam
carlin	carlin
chari	chari
tui	tui
bienveillante	benevolent
burnside	burnside
fritsch	fritsch
kasper	kasper
branchÃ©	trendy
branchÃ©	hip
subotica	subotica
anion	anion
chilton	chilton
omet	omits
omet	neglects
grimoire	grimoire
radicalisation	radicalization
radicalisation	radicalisation
amhara	amhara
bÃ´ne	bÃ´ne
monstrueuse	monstrous
monstrueuse	monster
janne	janne
amyot	amyot
bataclan	bataclan
sarsfield	sarsfield
castellum	castellum
guez	guez
chartrand	chartrand
godbout	godbout
pacs	pacs
amp	amp
amp	gpa
coexister	coexist
yamazaki	yamazaki
coster	coster
biggs	biggs
davie	davie
tchadienne	chadian
examinÃ©e	examined
haganah	haganah
sewell	sewell
brodÃ©	embroidered
fÃ©line	feline
chau	chau
anmen	anmen
berta	bertha
berta	berta
dutton	dutton
quesada	quesada
atc	atc
cassell	cassell
mollo	mollo
teofilo	teofilo
fouta	fouta
galeria	galeria
soupes	soups
soupes	soup
vaucouleurs	vaucouleurs
franziska	franziska
goo	goo
hussain	hussain
crans	notches
crans	crans
sanjay	sanjay
galen	galen
harlequins	harlequins
abymes	abymes
tierney	tierney
baa	baa
fas	fas
fas	saf
guidi	guidi
parnell	parnell
opportunistes	opportunist
opportunistes	opportunistic
dÃ©mocratiquement	democratically
Ã©jaculation	ejaculation
Ã©jaculation	ejaculate
sor	sor
cronos	cronos
schenker	schenker
fÅ“tale	foetal
soudÃ©	welded
rÃ©glementer	regulate
rÃ©glementer	regulating
benzema	benzema
veineuse	venous
avellaneda	avellaneda
colla	colla
tubize	tubize
rÃ©primÃ©	repressed
rÃ©primÃ©	suppressed
enfilade	enfilade
elinor	elinor
divergente	diverging
divergente	divergent
harada	harada
arnt	arnt
sns	sns
continuelle	continual
steinbach	steinbach
maryam	maryam
poreux	porous
passivitÃ©	passive
passivitÃ©	passivity
corbeilles	baskets
prÃ©dicateurs	preachers
sigebert	sigebert
krusty	krusty
campeonato	campeonato
picon	picon
Ã©thyle	ethyl
midrash	midrash
factice	dummy
pressÃ©s	pressed
wojtek	wojtek
aries	aries
bocal	jar
southland	southland
dussault	dussault
artwork	artwork
standardisÃ©e	standardised
standardisÃ©e	standardized
scheuer	scheuer
sheamus	sheamus
calmette	calmette
chalumeau	blowtorch
chalumeau	torch
marr	marr
acclamation	acclamation
intensivement	intensively
mahone	mahone
abies	abies
popp	popp
spyro	spyro
guillem	guillem
dÃ©sarmer	disarm
dÃ©sarmer	disarming
groening	groening
iberia	iberia
mds	mds
mds	dsm
saada	saada
nakano	nakano
vertÃ¨bre	vertebrae
vertÃ¨bre	vertebra
blackberry	blackberry
fibrose	fibrosis
pÃ©cs	pÃ©cs
larguÃ©	dumped
cruche	pitcher
cruche	jug
pÃ©nuries	shortages
vine	vine
pompon	pompon
baignÃ©e	bathed
briscoe	briscoe
sae	sae
petacchi	petacchi
atticus	atticus
placido	placido
ishihara	ishihara
figueras	figueras
enflammÃ©	ignited
enflammÃ©	inflamed
woodruff	woodruff
punie	punished
punie	punishable
punie	grounded
erratique	erratic
haÃ¯ku	haiku
malloy	malloy
microbienne	microbial
asd	asd
compliments	compliments
compliments	compliment
phys	phys
zÃ©lÃ©	zealous
longman	longman
sten	sten
amaya	amaya
facial	facial
scar	scar
srebrenica	srebrenica
gÃ©othermique	geothermal
insertions	insertions
lfc	lfc
leeuwarden	leeuwarden
expire	exhale
expire	expires
expire	expire
arequipa	arequipa
hermaphrodites	hermaphrodites
avarice	avarice
avarice	greed
stakhovsky	stakhovsky
saoudiens	saudis
webmaster	webmaster
fara	fara
bromley	bromley
rachael	rachael
fourgons	vans
lespinasse	lespinasse
osgood	osgood
clipper	clipper
famiglia	famiglia
posters	posters
mountbatten	mountbatten
aktion	aktion
lalaing	lalaing
manchette	headline
manchette	cuff
roja	roja
agacÃ©	annoyed
sutta	sutta
obra	obra
dewitt	dewitt
demir	demir
gimnasia	gimnasia
teaser	teaser
corrosif	corrosive
analysent	analyze
analysent	analyse
knudsen	knudsen
dictÃ©	dictated
vod	vod
aveuglement	blindness
aveuglement	blinding
augmentÃ©es	increased
augmentÃ©es	augmented
allouÃ©e	allocated
gstaad	gstaad
alu	alu
aia	aia
hardie	hardie
nakai	nakai
prÃ©sidences	presidencies
dupri	dupri
fragmentaire	fragmentary
fragmentaire	piecemeal
fragmentaire	fragmented
dga	dga
pÃ¤rt	pÃ¤rt
binda	binda
petrucci	petrucci
panthÃ¨res	panthers
panthÃ¨res	panther
geyer	geyer
tripp	tripp
palpatine	palpatine
salvi	salvi
glycine	glycine
naviguÃ©	sailed
valur	valur
tamaulipas	tamaulipas
azerbaÃ¯djanaise	azerbaijani
guÃ©rie	cured
guÃ©rie	healed
krueger	krueger
mercado	mercado
ludlow	ludlow
Ã©paisseurs	thicknesses
Ã©paisseurs	thickness
tokushima	tokushima
gam	gam
gorgone	gorgon
vibrer	vibrating
vibrer	vibrate
molinari	molinari
bayerische	bayerische
garvey	garvey
bardon	bardon
volatilitÃ©	volatile
volatilitÃ©	volatility
gravelle	gravelle
bretelles	suspenders
bretelles	straps
bretelles	braces
audubon	audubon
castaing	castaing
skype	skype
herreman	herreman
suplex	suplex
peshawar	peshawar
francke	francke
boole	boole
wyszkÃ³w	wyszkÃ³w
chaucer	chaucer
grece	greece
poignarde	stab
poignarde	stabs
warburton	warburton
verney	verney
peckinpah	peckinpah
hutchison	hutchison
mccord	mccord
daigo	daigo
busters	busters
simulacre	sham
moncey	moncey
maugham	maugham
inexpÃ©rience	inexperience
mazurka	mazurka
sÃ©minoles	seminoles
tresse	braid
enric	enric
interdÃ©pendance	interdependent
interdÃ©pendance	interdependence
nello	nello
lorena	lorena
tutu	tutu
dominical	dominical
ecu	ecu
anzoÃ¡tegui	anzoÃ¡tegui
dlr	dlr
pergola	pergola
lusaka	lusaka
inexorablement	inexorably
keren	keren
cattaneo	cattaneo
szamotuÅ‚y	szamotuÅ‚y
bombus	bombus
rochet	rochet
zuma	zuma
lansdowne	lansdowne
dÃ©gradant	degrading
haar	haar
isao	isao
eko	eko
mÃ©nestrel	minstrel
bonsaÃ¯	bonsai
rÃ©primÃ©es	repressed
gauvin	gauvin
prout	prout
yeo	yeo
gili	gili
vik	vik
gostyÅ„	gostyÅ„
perceptibles	perceptible
coo	coo
migrant	migrant
insinuations	innuendo
insinuations	insinuations
marlow	marlow
traÃ®nÃ©	trailed
traÃ®nÃ©	dragged
sremska	sremska
ergo	ergo
schule	schule
dissonance	dissonance
kayseri	kayseri
dÃ©sÃ©quilibres	imbalance
dÃ©sÃ©quilibres	imbalances
lewiston	lewiston
toa	toa
digressions	digressions
matÃ©rialiser	materialize
ziggy	ziggy
barfleur	barfleur
coriandre	coriander
anicet	anicet
rÃ©tractable	retractable
gavotte	gavotte
selkirk	selkirk
gygax	gygax
bartoszyce	bartoszyce
suwaÅ‚ki	suwaÅ‚ki
mordecai	mordecai
telemundo	telemundo
akai	akai
martelli	martelli
berenguer	berenguer
aylmer	aylmer
aiko	aiko
ravager	ravager
ravager	ravage
palgrave	palgrave
jamestown	jamestown
syllabique	syllabics
windham	windham
kiso	kiso
obsessions	obsessions
helsingborgs	helsingborgs
tarquinia	tarquinia
gracieusement	graciously
gracieusement	gracefully
barat	barat
ojeda	ojeda
fogg	fogg
sÃ¡enz	sÃ¡enz
duckworth	duckworth
piccard	piccard
commotion	concussion
herbst	herbst
ortie	nettle
aye	aye
nguyÃªn	nguyÃªn
beausoleil	beausoleil
rab	rab
gte	gte
mackey	mackey
mev	mev
pÃ©ruviens	peruvian
prÃ©occupante	worrying
libert	libert
rong	rong
prevost	prevost
olivares	olivares
marija	marija
ctenotus	ctenotus
tolÃ©rÃ©s	tolerated
yuriy	yuriy
jutta	jutta
inÃ©branlable	unwavering
inÃ©branlable	unshakeable
inÃ©branlable	steadfast
cornwallis	cornwallis
citrons	lemon
citrons	lemons
santorin	santorini
moineaux	sparrows
linÃ©airement	linearly
sappho	sappho
infirmitÃ©	disability
infirmitÃ©	infirmity
fellgiebel	fellgiebel
activÃ©es	enabled
activÃ©es	activated
ryanair	ryanair
dumbo	dumbo
rho	rho
mosan	mosan
maoÃ¯stes	maoist
maoÃ¯stes	maoists
roadrunners	roadrunners
ignatiev	ignatiev
interrÃ©gionale	interregional
pathfinder	pathfinder
kendra	kendra
talmudique	talmudic
linky	linky
polona	polona
bÃ¼rgermeister	bÃ¼rgermeister
bellot	bellot
asperge	asparagus
paulson	paulson
gonthier	gonthier
belgiÃ«	belgiÃ«
adÃ©lard	adÃ©lard
scanners	scanners
kunio	kunio
aggravant	aggravating
importateurs	importer
importateurs	importers
olmedo	olmedo
laing	laing
gasol	gasol
amritraj	amritraj
lio	lio
wijk	wijk
viale	viale
kannon	kannon
arta	arta
limonade	lemonade
rÃ©volutionnÃ©	revolutionized
pallida	pallida
foreurs	foreurs
surpoids	overweight
situationniste	situationist
Ã©quilibrÃ©s	balanced
salviati	salviati
fongiques	fungal
berryz	berryz
hartmut	hartmut
amadis	amadis
weyden	weyden
aerts	aerts
jodi	jodi
perestroÃ¯ka	perestroika
kenzo	kenzo
badiou	badiou
cytochrome	cytochrome
jarod	jarod
terrell	terrell
aarschot	aarschot
qasim	qasim
examinÃ©es	examined
adroit	adroit
incessante	incessant
moncada	moncada
vishnu	vishnu
canzone	canzone
hakone	hakone
grÃ©try	grÃ©try
jammes	jammes
brioche	brioche
brioche	bun
baudot	baudot
menottes	handcuffs
menottes	cuffs
effrayÃ©s	frightened
cyan	cyan
alitalia	alitalia
seveso	seveso
emo	emo
centurions	centurions
predrag	predrag
polyurÃ©thane	polyurethane
sarmates	sarmatians
galan	galan
broeck	broeck
historica	historica
editori	editori
lamentation	lamentation
butterworth	butterworth
kiko	kiko
valentia	valentia
gallen	gallen
vÃ©rificateurs	auditors
vae	vae
thalassa	thalassa
bulldozer	bulldozer
jugurtha	jugurtha
cocotte	casserole
donahue	donahue
barclays	barclays
barthelemy	barthelemy
willibald	willibald
clubiona	clubiona
krypton	krypton
koper	koper
intermedius	intermedius
quasar	quasar
blitzkrieg	blitzkrieg
denham	denham
rajeunir	rejuvenating
rajeunir	rejuvenate
spÃ©culateurs	speculators
perverse	pervert
perverse	kinky
perverse	perverse
perverse	perverted
renshaw	renshaw
straubing	straubing
tikal	tikal
vladikavkaz	vladikavkaz
fractionnement	fractionation
fractionnement	splitting
dÃ©pliant	leaflet
dÃ©pliant	brochure
dÃ©pliant	folder
dÃ©pliant	flyer
dÃ©pliant	pamphlet
sulfures	sulphide
bist	bist
crkva	crkva
madara	madara
chandos	chandos
modelage	modeling
modelage	modelling
maciel	maciel
ondulations	ripples
Å‚Ä™czna	Å‚Ä™czna
infirmes	cripples
infirmes	infirm
bernina	bernina
confits	crystallized
confits	candied
packs	packs
esme	esme
quenya	quenya
gordy	gordy
afd	afd
xhtml	xhtml
essling	essling
humblot	humblot
rÃ©itÃ©rer	reiterate
rÃ©itÃ©rer	reiterating
texel	texel
ldu	ldu
engelmann	engelmann
delpy	delpy
foudroyant	foudroyant
jute	jute
calas	calas
tejada	tejada
hagan	hagan
assaillant	attacker
assaillant	assailant
villalba	villalba
pye	pye
motorsports	motorsports
whitlam	whitlam
lauriston	lauriston
playlist	playlist
bientot	soon
multicolore	colorful
corticoÃ¯des	corticosteroids
corticoÃ¯des	steroids
mateusz	mateusz
superleague	superleague
ebenezer	ebenezer
ovw	ovw
friedberg	friedberg
ferghana	ferghana
monomÃ¨re	monomer
carats	carat
carats	carats
suger	suger
salutation	greeting
volos	volos
philippoussis	philippoussis
vari	vari
kis	kis
jukka	jukka
lace	lace
jett	jett
gigue	gigue
ludwigslust	ludwigslust
coÃ¯ncidant	coinciding
Ã©branlÃ©	shaken
Ã©branlÃ©	shook
atherton	atherton
piÃ©geage	trapping
dÃ©ficients	deficient
canarias	canarias
mab	mab
kroll	kroll
fÃ¶r	fÃ¶r
tchou	choo
selecta	selecta
messer	messer
aquarius	aquarius
savy	savy
callum	callum
salvini	salvini
placage	plating
placage	veneers
placage	veneer
balanÃ§oire	swings
balanÃ§oire	swing
jindÅ™ichÅ¯v	jindÅ™ichÅ¯v
barrÃ¨re	barrÃ¨re
bri	bri
melons	melon
melons	melons
lactation	lactating
lactation	lactation
agressÃ©e	assaulted
agressÃ©e	attacked
shem	shem
rÃ©activation	reactivation
lamennais	lamennais
tsunamis	tsunami
tsunamis	tsunamis
glinka	glinka
mcc	mcc
reiser	reiser
cherubini	cherubini
varanus	varanus
bisous	kisses
gemayel	gemayel
orio	orio
aÃ©rer	airing
amba	amba
coulait	flowed
prÃ©juger	prejudge
dÃ©couragement	discouragement
dÃ©couragement	discouraged
bozo	bozo
dÃ©tonateur	detonator
leasing	leasing
brahma	brahma
jeanneret	jeanneret
evry	evry
rÃ©parateur	repair
rÃ©parateur	repairman
giga	giga
takahiro	takahiro
kolkata	kolkata
gharbi	gharbi
sadisme	sadism
srt	srt
rosay	rosay
seta	seta
mamba	mamba
bÃ¡cs	bÃ¡cs
downes	downes
pcp	pcp
pcp	cfp
rÃ©pressives	repressive
stoller	stoller
anil	anil
midtjylland	midtjylland
riboud	riboud
latifolia	latifolia
maren	maren
ducis	ducis
pressburger	pressburger
strasser	strasser
Ã©touffÃ©e	smothered
Ã©touffÃ©e	stifled
fluctuation	fluctuation
marylebone	marylebone
saya	saya
vejle	vejle
borodine	borodin
inonder	flood
inonder	flooding
morosini	morosini
pywikipedia	pywikipedia
dÃ©taillants	retailers
orantes	orantes
asch	asch
iroda	iroda
accostÃ©	accosted
frÃ©nÃ©tique	frenzy
frÃ©nÃ©tique	frantic
frÃ©nÃ©tique	frenzied
iÃ±aki	iÃ±aki
kozlov	kozlov
leman	leman
divisÃ£o	divisÃ£o
foss	foss
brahman	brahman
grÃ¼nen	grÃ¼nen
nolte	nolte
Ã¥ke	Ã¥ke
gilman	gilman
lÃ¶wen	lÃ¶wen
laidlaw	laidlaw
coraniques	koranic
clodius	clodius
sophistes	sophists
gassman	gassman
gourde	gourd
gourde	canteen
Ã©cueils	pitfalls
doggett	doggett
quiero	quiero
brevetÃ©e	patented
impÃ©tueux	impetuous
pochoir	stencil
schwarze	schwarze
contention	restraint
contention	contention
crÃ¼e	crÃ¼e
traÃ®trise	treachery
ivanova	ivanova
lederman	lederman
habillÃ©es	dressed
vab	vab
vab	gva
oflag	oflag
dewoitine	dewoitine
spontanÃ©s	spontaneous
anesthÃ©sique	anesthetic
anesthÃ©sique	anaesthetic
intranet	intranet
tompkins	tompkins
Å›wiebodzin	Å›wiebodzin
ddg	ddg
ect	ect
hÃ©tÃ©rosexuel	heterosexual
lanark	lanark
plas	plas
cerami	cerami
merri	merri
hoskins	hoskins
expropriations	expropriations
minuta	minuta
ballo	ballo
bhl	bhl
firebird	firebird
cÃºcuta	cÃºcuta
nast	nast
insensibles	insensitive
matton	matton
giard	giard
dÃ©missions	resignations
aep	aep
narayan	narayan
rÃ©futÃ©	refuted
dÃ¼ren	dÃ¼ren
mulcahy	mulcahy
daubigny	daubigny
fdf	fdf
interfÃ¨re	interferes
yuna	yuna
lemos	lemos
nostrand	nostrand
brÃ©mond	brÃ©mond
ennuyer	bore
ennuyer	bored
koninck	koninck
sirois	sirois
frederiksberg	frederiksberg
giteau	giteau
rafi	rafi
perfide	treacherous
fard	fard
europÃ¤ische	europÃ¤ische
gallegos	gallegos
utrillo	utrillo
weed	weed
castellan	castellan
passives	passive
prÃ´ner	advocating
tÃ©l	tel
souriante	smiling
kliÅ¾an	kliÅ¾an
andin	andean
thalberg	thalberg
comanches	comanche
comanches	comanches
martorell	martorell
versace	versace
palilula	palilula
shania	shania
nap	nap
geddes	geddes
litanie	litany
coachs	coaches
marga	marga
kumasi	kumasi
siete	siete
electronique	electronics
electronique	electronic
buffer	buffer
grossistes	wholesaler
grossistes	wholesale
grossistes	wholesalers
mccloud	mccloud
cte	cte
Ã©lectrostatiques	electrostatic
stabilisant	stabilising
stabilisant	stabiliser
stabilisant	stabilizer
stabilisant	stabilizing
aguiar	aguiar
oblasts	oblasts
eichstÃ¤tt	eichstÃ¤tt
ngÃ´	ngÃ´
heilig	heilig
wadsworth	wadsworth
piaggio	piaggio
ramzy	ramzy
csaba	csaba
occipital	occipital
finisterre	finisterre
spacieuse	spacious
spacieuse	roomy
stratus	stratus
mercosur	mercosur
martiÄ‡	martiÄ‡
cytokines	cytokines
imsa	imsa
qualitativement	qualitatively
imi	imi
ahuntsic	ahuntsic
guang	guang
heisler	heisler
durci	hardened
danubio	danubio
hockenheim	hockenheim
seguso	seguso
sittard	sittard
dukas	dukas
fipa	fipa
sema	sema
mahony	mahony
motoneige	snowmobile
motoneige	snowmobiles
coopÃ©ratifs	cooperative
lucullus	lucullus
radzyÅ„	radzyÅ„
caixa	caixa
tourment	torment
huth	huth
stjepan	stjepan
transgÃ©niques	transgenic
rabo	rabo
bÃ©kÃ©s	bÃ©kÃ©s
hodgkin	hodgkin
jintao	jintao
superamas	superclusters
mobygames	mobygames
biceps	biceps
sarda	sarda
catwoman	catwoman
gottes	gottes
chiari	chiari
lindisfarne	lindisfarne
remodelÃ©	remodelled
poignant	poignant
Ä‘á»“ng	Ä‘á»“ng
koukalovÃ¡	koukalovÃ¡
nakazawa	nakazawa
bbs	bbs
abattement	abatement
terpstra	terpstra
viipuri	viipuri
trina	trina
nimbus	nimbus
melton	melton
hÃ´tesses	hostesses
hÃ´tesses	hostess
rydell	rydell
stearns	stearns
broyÃ©	crushed
gaitÃ¡n	gaitÃ¡n
thunderdome	thunderdome
aspergillus	aspergillus
Ã©numÃ©rer	enumerate
garten	garten
bubo	bubo
synapse	synapse
slattery	slattery
yasuhiro	yasuhiro
vaccinium	vaccinium
naguib	naguib
llano	llano
gerbille	gerbil
kwong	kwong
broussard	broussard
kaitlyn	kaitlyn
permaculture	permaculture
middletown	middletown
wesolowska	wesolowska
progressifs	progressive
pitons	pitons
emelec	emelec
rocchi	rocchi
katayama	katayama
prometteuses	promising
rouff	rouf
tillie	tillie
maalouf	maalouf
rajoy	rajoy
strode	strode
appendicite	appendicitis
raccordÃ©e	connected
etta	etta
honeywell	honeywell
lamarr	lamarr
nereis	nereis
cedeao	ecowas
poir	poir
platonique	platonic
markku	markku
blanchette	blanchette
portas	portas
gouttiÃ¨res	gutters
valea	valea
sjÃ¶strÃ¶m	sjÃ¶strÃ¶m
purdy	purdy
hÃ©gÃ©monique	hegemonic
valentÃ­n	valentÃ­n
smollett	smollett
boehm	boehm
cancÃºn	cancÃºn
animus	animus
castaÃ±eda	castaÃ±eda
missolonghi	missolonghi
fondamentaliste	fundamentalist
panatta	panatta
ombra	ombra
foerster	foerster
angora	angora
corbet	corbet
doctrinales	doctrinal
vissel	vissel
niet	niet
amb	amb
mcg	mcg
yakima	yakima
finck	finck
braconniers	poaching
braconniers	poacher
braconniers	poachers
shinano	shinano
andantino	andantino
naturgeschichte	naturgeschichte
ramillies	ramillies
epub	epub
offensÃ©	offended
takamatsu	takamatsu
avron	avron
expÃ©rimentÃ©es	experienced
confessionnelles	denominational
abgar	abgar
saturniidae	saturniidae
pÃ©rignon	pÃ©rignon
divulguÃ©	leaked
divulguÃ©	disclosed
realgm	realgm
rawlings	rawlings
tazio	tazio
vaca	vaca
gradation	gradation
kranz	kranz
orp	orp
blob	blob
rosson	rosson
canaletto	canaletto
klÃ¶den	klÃ¶den
generis	generis
schulte	schulte
hanlon	hanlon
gardiennage	safekeeping
gardiennage	babysitting
sharman	sharman
pickens	pickens
gorgias	gorgias
bouzouki	bouzouki
bever	bever
bornemisza	bornemisza
scritti	scritti
apn	apn
hÃ¢ter	hasten
masjid	masjid
testeurs	testers
frÃ½dek	frÃ½dek
tibesti	tibesti
voo	voo
donohue	donohue
atelopus	atelopus
smp	smp
benassi	benassi
lafrance	lafrance
pharmacologiques	pharmacological
pubis	pubis
montepulciano	montepulciano
ogilvy	ogilvy
wiltz	wiltz
tallec	tallec
ppd	ppd
moscovici	moscovici
megami	megami
mubarak	mubarak
agrÃ©ments	approvals
agrÃ©ments	accreditations
incurables	incurables
yeh	yeh
cesi	cesi
coleraine	coleraine
antioxydants	antioxidant
antioxydants	antioxidants
porcin	porcine
ankaragÃ¼cÃ¼	ankaragÃ¼cÃ¼
ausf	ausf
bassus	bassus
abdelwahab	abdelwahab
borrelia	borrelia
pacini	pacini
negi	negi
rastafari	rastafari
brackett	brackett
weisman	weisman
riparia	riparia
cef	cef
cef	efc
amata	amata
sadiki	sadiki
aubergines	eggplant
domo	domo
saoul	drunk
kÃ¼hn	kÃ¼hn
corroborer	corroboration
corroborer	corroborated
corroborer	corroborating
corroborer	corroborate
rah	rah
antonietta	antonietta
lunga	lunga
graetz	graetz
mÃ©thionine	methionine
dsk	dsk
schistura	schistura
tortueux	tortuous
capelli	capelli
lisandro	lisandro
loring	loring
tindouf	tindouf
tÅ™inec	tÅ™inec
teemu	teemu
alon	alon
bakri	bakri
harker	harker
flagg	flagg
yoshikawa	yoshikawa
nya	nya
comps	comps
spottiswoode	spottiswoode
florus	florus
weezer	weezer
typologies	typologies
biodÃ©gradables	biodegradable
civilitÃ©	civility
kwa	kwa
cers	esrb
cers	cers
adelheid	adelheid
brodsky	brodsky
appariement	matching
cavalleria	cavalleria
martinson	martinson
mariotte	mariotte
nagato	nagato
doxa	doxa
superficiellement	superficially
incontestÃ©e	uncontested
rial	rial
tls	tls
pÃ©nalisation	criminalization
ramey	ramey
winkle	winkle
dalia	dalia
stx	stx
nemes	nemes
descripteurs	descriptors
teton	teton
tourmalet	tourmalet
suoi	suoi
szombathely	szombathely
dutoit	dutoit
leopardi	leopardi
sombrero	sombrero
korg	korg
istro	istro
chÃ¢le	shawl
sch	sch
balaton	balaton
lavoro	lavoro
prospecteur	prospector
coÃ¯t	coitus
rotatives	rotating
rotatives	rotary
refroidie	cooled
volapÃ¼k	volapÃ¼k
opie	ope
opie	opie
stg	tsg
boulgou	boulgou
technicienne	technician
sorge	sorge
pernet	pernet
bulla	bulla
streptococcus	streptococcus
draveurs	draveurs
hoare	hoare
piratÃ©	hacked
aviculture	aviculture
pinay	pinay
rogell	rogell
colvin	colvin
lexie	lexie
merrie	merrie
ennuyeuse	boring
ennuyeuse	annoying
kilmer	kilmer
eider	eider
foll	foll
abr	abr