midlothian	midlothian
cons	wider
cons	nachteile
pragmatic	pragmatischen
pragmatic	pragmatische
pragmatic	pragmatisch
mathematically	mathematisch
fung	fung
whitfield	whitfield
gino	gino
gabriela	gabriela
enzo	enzo
madeline	madeline
camilla	camilla
piles	stapel
agitation	agitation
agitation	erregung
agitation	aufregung
agitation	unruhe
waverley	waverley
iptv	iptv
hasidic	chassidischen
asians	asiaten
screams	schreie
screams	schreit
niles	niles
cascades	cascades
babel	babel
horowitz	horowitz
philosophies	philosophien
finley	finley
tod	tod
yaroslavl	jaroslawl
wikiversity	wikiversity
tula	tula
furnishings	mÃ¶bel
furnishings	ausstattung
furnishings	einrichtung
furnishings	mobiliar
bypassed	Ã¼bergangen
bypassed	umgangen
misrepresentation	falschdarstellung
mantra	mantra
gangsta	gangster
gangsta	gangsta
fray	fray
sober	trocken
sober	nÃ¼chtern
sober	nÃ¼chternen
phnom	phnom
bundles	bÃ¼ndel
bundles	bÃ¼ndeln
sugarcane	zuckerrohr
appliance	apparatur
appliance	gerÃ¤t
apical	apikalen
chelmsford	chelmsford
gamecube	gamecube
columnists	kolumnisten
palladium	palladium
movable	bewegliche
movable	beweglich
movable	beweglichen
movable	bewegliches
embryonic	embryonalen
embryonic	embryonale
stratton	stratton
sidi	sidi
martino	martino
ramat	ramat
jacinto	jacinto
ordovician	ordovizium
surprises	Ã¼berraschungen
surprises	Ã¼berraschung
fitch	fitch
romanticism	romantik
kari	kari
entomologist	entomologe
tait	tait
wreath	kranz
cagliari	cagliari
bela	bela
vorpommern	vorpommern
deprivation	benachteiligung
priestley	priestley
openness	aufgeschlossenheit
openness	offenheit
openness	Ã¶ffnung
offshoot	ableger
carrera	carrera
accelerating	beschleunigen
accelerating	beschleunigung
accelerating	beschleunigte
accelerating	beschleunigt
cornwallis	cornwallis
gillette	gillette
boosted	beworben
boosted	beworbenen
britons	briten
blount	blount
lucian	lucian
accustomed	gewÃ¶hnen
accustomed	gewÃ¶hnt
accustomed	gewohnt
yee	yee
magneto	magneto
shakti	shakti
enix	enix
retract	zurÃ¼cknehmen
retract	einfahren
retract	widerrufen
retract	zurÃ¼ckziehen
publicist	publizist
foreigner	auslÃ¤nder
downloading	herunterladen
juliana	juliana
britton	britton
cooks	kÃ¶che
dreyfus	dreyfus
behaving	benimmt
galleria	galleria
scooter	scooter
scooter	moped
scooter	roller
gecko	gecko
subaru	subaru
mcculloch	mcculloch
fiddler	fiddler
andromeda	andromeda
harriers	harriers
wick	wick
graphite	graphit
sounders	sounders
intergovernmental	zwischenstaatlicher
intergovernmental	zwischenstaatliche
intergovernmental	zwischenstaatlichen
tripura	tripura
esquire	esquire
eriksson	eriksson
bitten	gebissen
darfur	darfur
dole	dole
trÃ¸ndelag	trÃ¸ndelag
prosecute	strafverfolgung
drexel	drexel
sinaloa	sinaloa
bess	bess
rubÃ©n	rubÃ©n
lowercase	kleines
lowercase	kleinbuchstaben
lowercase	kleinschreibung
obelisk	obelisk
rtl	rtl
gabriele	gabriele
professed	erklÃ¤rten
geffen	geffen
primal	ursprÃ¼ngliche
primal	primal
primal	ursprÃ¼nglicher
litres	litern
litres	liter
forage	futter
forage	futterpflanzen
cheerful	heiter
cheerful	frÃ¶hlich
cheerful	frÃ¶hliche
millet	hirse
behaved	benommen
fawcett	fawcett
bhp	bhp
architectures	architekturen
tabriz	tÃ¤bris
piety	gottesfurcht
piety	frÃ¶mmigkeit
bicentennial	bicentennial
ananda	ananda
playlist	playlist
monstrous	monstrÃ¶se
niall	niall
junkers	junkers
protons	protonen
uneasy	unwohl
uneasy	unruhig
murad	murad
murad	murat
gangsters	gangster
canine	hund
canine	hunde
rockland	rockland
bianchi	bianchi
duality	dualitÃ¤t
scarcity	knappheit
scarcity	verknappung
scarcity	seltenheit
plummer	plummer
treatises	abhandlungen
hajj	wallfahrt
hajj	pilgerfahrt
bushes	gebÃ¼sch
bushes	bÃ¼sche
matchday	spieltag
wittenberg	wittenberg
vÃ©lez	vÃ©lez
cried	schrie
cried	weinte
cried	geweint
cried	rief
cried	geschrien
goliath	goliath
ibis	ibis
sandhurst	sandhurst
sarcasm	sarkasmus
mekong	mekong
levied	erhoben
levied	erhobene
hegemony	vorherrschaft
hegemony	hegemonie
palsy	lÃ¤hmung
omer	omer
drank	trank
drank	tranken
drank	getrunken
sheehan	sheehan
lagrange	lagrange
formulate	formulieren
chechnya	tschetschenien
ezekiel	ezekiel
gaspar	gaspar
columba	columba
segal	segal
landis	landis
serotonin	serotonin
hinckley	hinckley
jÃ¡nos	jÃ¡nos
sus	sus
harrogate	harrogate
ammonium	ammonium
curators	kuratoren
transitive	transitiv
contour	kontur
contour	konturen
equip	auszustatten
equip	ausstatten
equip	rÃ¼sten
decisively	entschieden
unjustified	ungerechtfertigte
unjustified	unbegrÃ¼ndet
unjustified	ungerechtfertigt
keegan	keegan
concave	konkav
immanuel	immanuel
cale	cale
workman	workman
schenectady	schenectady
recurrence	wiederkehr
recurrence	wiederholung
xxxx	xxxx
nadine	nadine
weary	Ã¼berdrÃ¼ssig
weary	mÃ¼de
aceh	aceh
foes	feinde
cooperated	zusammengearbeitet
cooperated	kooperiert
cooperated	arbeitete
cooperated	mitgearbeitet
conduit	abgleich
ruskin	ruskin
errol	errol
luminosity	leuchtkraft
luminosity	helligkeit
luminosity	lichtstÃ¤rke
pitman	pitman
robo	robo
disgusted	empÃ¶rt
disgusted	ekel
disgusted	angewidert
jie	jie
goodnight	goodnight
paley	paley
leela	leela
sharjah	sharjah
interfered	eingegriffen
indore	indore
sakai	sakai
sander	sander
preventative	vorbeugende
preventative	prÃ¤ventiv
preventative	prÃ¤ventive
carts	einkaufswagen
carts	karren
mansur	mansur
druze	drusen
thorns	dornen
skeptics	skeptiker
choreographers	choreographen
audible	akustische
tuttle	tuttle
adriano	adriano
rumour	gerÃ¼cht
rumour	gerÃ¼chte
tonkin	tonkin
wand	zauberstab
wand	wand
desai	desai
battered	zugerichtet
battered	geschlagene
nicol	nicol
kip	kip
chernobyl	tschernobyl
chernobyl	chernobyl
gunther	gÃ¼nter
gunther	gunther
gunther	gÃ¼nther
carinthia	kÃ¤rnten
paulus	paulus
faraday	faraday
dictates	diktiert
hindenburg	hindenburg
grotesque	grotesk
delia	delia
wallpaper	tapeten
wallpaper	hintergrund
wallpaper	hintergrundbild
wallpaper	tapete
sikorsky	sikorsky
kline	kline
niÅ¡	niÅ¡
harden	harden
rennie	rennie
cambria	cambria
condominium	wohnanlage
condominium	kondominium
hesitation	zÃ¶gert
hesitation	zÃ¶gern
narendra	narendra
trentino	trentino
hamad	hamad
sucker	trottel
obi	obi
ayres	ayres
upkeep	instandhaltung
montessori	montessori
bolivar	bolivar
pitts	pitts
digger	digger
garnet	garnet
interrogated	verhÃ¶rt
interrogated	abgefragt
hikers	wanderer
serpentine	serpentine
purged	bereinigt
purged	gesÃ¤ubert
lubusz	lebus
necropolis	nekropole
firefighter	feuerwehrmann
firefighter	feuerwehr
colossus	koloss
assay	assay
assay	test
intangible	immateriellen
intangible	immaterielle
niki	niki
electrostatic	elektrostatische
halsey	halsey
prudent	umsichtige
prudent	vorsichtige
prudent	umsichtig
gpa	gpa
triumphant	siegreich
triumphant	erfolgreichen
multan	multan
refine	verfeinerung
refine	verfeinern
contractions	wehen
kershaw	kershaw
anthrax	anthrax
interpreters	dolmetscher
rubinstein	rubinstein
multiplex	multiplex
kuo	kuo
weave	weben
kiki	kiki
robby	robby
ounce	unze
hopelessly	hoffnungslos
equate	gleichzusetzen
marr	marr
selwyn	selwyn
bint	bint
samuels	samuels
rosetta	rosetta
thesaurus	thesaurus
kaya	kaya
valour	tapferkeit
flocks	herden
carnage	blutvergieÃŸen
carnage	blutbad
carnage	gemetzel
suwon	suwon
leif	leif
headaches	kopfschmerzen
tot	tot
permutation	permutation
suzy	suzy
almerÃ­a	almerÃ­a
unison	unison
rem	rem
zeno	zeno
guessed	vermutet
guessed	vermutete
guessed	geraten
guessed	erraten
arabi	arabi
restitution	rÃ¼ckgabe
zine	zine
staffing	personal
staffing	personalbestand
dismisses	entlÃ¤sst
authoring	authoring
xyz	xyz
maoist	maoistischen
uda	uda
carbine	karabiner
porous	porÃ¶se
skype	skype
hogarth	hogarth
clowns	clowns
swe	swe
sacraments	sakramente
mihai	mihai
subtly	subtil
willi	willi
armaments	rÃ¼stungsindustrie
armaments	rÃ¼stung
armaments	bewaffnung
herbaceous	krautige
uncontrolled	unkontrolliert
uncontrolled	unkontrollierten
uncontrolled	unkontrollierte
staring	starren
staring	starrt
taranto	tarent
kansai	kansai
cmg	cmg
lawmakers	gesetzgeber
tessa	tessa
stickers	sticker
stickers	aufkleber
esprit	esprit
shlomo	shlomo
enlarge	vergrÃ¶ÃŸerung
enlarge	erweitern
enlarge	vergrÃ¶ÃŸern
enlarge	erweiterung
praia	praia
haste	eile
haste	haste
eradicate	ausrottung
eradicate	beseitigen
eradicate	auslÃ¶schen
vitamins	vitamine
vitamins	vitaminen
tuskegee	tuskegee
ostrava	ostrava
lonsdale	lonsdale
mcdonough	mcdonough
steeple	turm
steeple	kirchturm
lawless	lawless
salas	salas
afrika	afrika
santi	santi
frasier	frasier
doge	doge
csu	csu
molotov	molotow
dividends	dividenden
dividends	dividende
sanctuaries	schutzgebiete
sanctuaries	heiligtÃ¼mer
satb	satb
esposito	esposito
jeannie	jeannie
simcoe	simcoe
competency	kompetenz
competency	befÃ¤higung
charlestown	charlestown
cauldron	kessel
shostakovich	schostakowitsch
alphabets	alphabete
querÃ©taro	querÃ©taro
kindle	kindle
whittier	whittier
poincarÃ©	poincarÃ©
ittihad	ittihad
chilling	kÃ¼hlen
freshly	frisch
aydÄ±n	aydÄ±n
Ã©glise	Ã©glise
liquidity	liquiditÃ¤t
carmarthen	carmarthen
degeneration	degeneration
cavities	hohlrÃ¤ume
eusebius	eusebius
arco	arco
womb	gebÃ¤rmutter
womb	mutterleib
mchale	mchale
yevgeny	jewgeni
pascoe	pascoe
bianco	bianco
viceroyalty	vizekÃ¶nigreich
bader	bader
naylor	naylor
parable	gleichnis
svp	svp
mian	mian
dodson	dodson
naturalistic	naturalistischen
plunkett	plunkett
mah	mah
sexist	sexistisch
langston	langston
nicotine	nikotin
shinji	shinji
strut	strebe
disgruntled	verÃ¤rgerte
prerogative	vorrecht
janusz	janusz
agm	agm
agm	hv
agm	hauptversammlung
asc	asc
swifts	swifts
lovett	lovett
gaseous	gasfÃ¶rmigen
gaseous	gasfÃ¶rmiger
gaseous	gasfÃ¶rmige
decorating	dekoration
decorating	schmÃ¼cken
decorating	dekorieren
pocahontas	pocahontas
baillie	baillie
kippur	kippur
goodrich	goodrich
espinosa	espinosa
marcy	marcy
manche	manche
zeeland	zeeland
zeeland	seeland
hough	hough
bakshi	bakshi
outweigh	Ã¼berwiegen
jervis	jervis
footpaths	wanderwege
footpaths	wanderwegen
celts	kelten
dismissive	abweisend
jackal	schakal
pastel	pastell
deerfield	deerfield
toshiba	toshiba
caverns	hÃ¶hlen
ces	ces
lewisham	lewisham
ekaterina	jekaterina
ashcroft	ashcroft
phu	phu
miao	miao
cadbury	cadbury
diabetic	diabetischen
diabetic	diabetiker
diabetic	diabetes
gilliam	gilliam
beowulf	beowulf
heinlein	heinlein
proactive	eigeninitiative
proactive	vorausschauend
proactive	aktiv
jolie	jolie
democratically	demokratisch
fanbase	fanbasis
lagoons	lagunen
lagoons	lagune
outbuildings	nebengebÃ¤ude
nez	nez
gatineau	gatineau
dekker	dekker
rainwater	regenwasser
resumption	wiederaufnahme
loanwords	lehnwÃ¶rter
enforcer	vollstrecker
daimyo	daimyÅ
gazelle	gazelle
hallows	hallows
cuff	handschellen
shaftesbury	shaftesbury
mircea	mircea
nationalized	verstaatlicht
manifests	manifestiert
congressmen	kongressabgeordneten
congressmen	kongressabgeordnete
hashimoto	hashimoto
muni	muni
discouraging	entmutigt
discouraging	entmutigen
seong	seong
fenway	fenway
archimedes	archimedes
seabirds	seevÃ¶gel
ahmadinejad	ahmadinedschad
pinot	pinot
grids	raster
grids	netze
grids	gitter
shriver	shriver
valet	diener
rua	rua
rocca	rocca
hervey	hervey
orne	orne
denominator	nenner
mahmood	mahmood
cpl	cpl
pcc	pcc
strangled	erwÃ¼rgt
schiff	schiff
tonbridge	tonbridge
rectify	berichtigen
rectify	korrigieren
peso	pesos
peso	peso
alleles	allele
apoel	apoel
spoilers	spoiler
decimated	dezimiert
warlock	warlock
actuality	aktualitÃ¤t
actuality	wirklichkeit
artois	artois
circulate	zirkulieren
circulate	umlauf
maimonides	maimonides
vistula	weichsel
benetton	benetton
overruled	abgewiesen
overruled	Ã¼berstimmt
braddock	braddock
forwarding	weiterleitung
forwarding	spedition
forwarding	Ã¼bermittlung
forwarding	weiterleiten
scania	schonen
scania	scania
krupp	krupp
mots	mots
cuomo	cuomo
bessarabia	bessarabien
shakes	shakes
shakes	schÃ¼ttelt
braÈ™ov	braÈ™ov
dredging	baggerarbeiten
nominative	nominativ
randi	randi
fsv	fsv
rarities	raritÃ¤ten
triptych	triptychon
badajoz	badajoz
kolonia	kolonia
pawnee	pawnee
vases	vasen
hae	hae
cheerleader	cheerleader
hmcs	hmcs
valenzuela	valenzuela
maddie	maddie
herding	hÃ¼ten
rainey	rainey
presse	presse
carina	carina
baal	baal
roost	roost
desi	desi
bhakti	bhakti
padova	padua
padova	padova
stressing	gestresst
sterilization	sterilisation
apparition	erscheinung
luang	luang
liters	litern
liters	liter
diaphragm	zwerchfell
diaphragm	membran
diaphragm	membranen
paddock	paddock
gurkha	gurkha
loring	loring
mckinnon	mckinnon
alva	alva
strapped	geschnallt
nyse	nyse
precede	vorausgehen
formalism	formalismus
spoils	beute
spoils	verwÃ¶hnt
spoils	verdirbt
sydenham	sydenham
europaea	europaea
brow	stirn
brow	augenbrauen
kowalski	kowalski
cocoon	kokon
smt	smt
jacobus	jacobus
habitual	gewÃ¶hnlichen
ats	ats
mendocino	mendocino
nuncio	nuntius
grin	grinsen
arrondissements	arrondissements
circumstantial	indizien
rik	rik
gatwick	gatwick
reloaded	reloaded
wandsworth	wandsworth
gurus	gurus
langton	langton
tem	tem
deathbed	sterbebett
cantonal	kantonalen
cantonal	kantone
setlist	setlist
smack	ohrfeige
symbolized	symbolisiert
carrollton	carrollton
gibberish	kauderwelsch
shockwave	shockwave
angelic	engel
ciel	ciel
inhalation	inhalation
inhalation	einatmen
brasileira	brasileira
chak	chak
repatriated	zurÃ¼ckgefÃ¼hrt
danbury	danbury
martine	martine
christos	christos
passionately	leidenschaftlich
badr	badr
almagro	almagro
illogical	unlogisch
retarded	zurÃ¼ckgeblieben
retarded	behindert
asynchronous	asynchrone
injections	injektionen
injections	spritzen
tÃ¢rgu	tÃ¢rgu
daybreak	tagesanbruch
nigra	nigra
harwich	harwich
huerta	huerta
rework	Ã¼berarbeitung
rework	Ã¼berarbeiten
bhattacharya	bhattacharya
pave	ebnen
haha	haha
llywelyn	llywelyn
ghostbusters	ghostbusters
buda	buda
solihull	solihull
zaman	zaman
abbÃ©	abbÃ©
bracelets	armbÃ¤nder
entrant	marktteilnehmer
entrant	teilnehmers
peebles	peebles
paloma	paloma
moll	moll
kreuz	kreuz
copious	ausgiebigen
ahern	ahern
xander	xander
metallurgical	metallindustrie
metallurgical	metallurgische
metallurgical	metallurgie
globular	kugelfÃ¶rmige
militiamen	milizionÃ¤re
nutcracker	nussknacker
schulze	schulze
berthold	berthold
kearny	kearny
visualize	visualisieren
galleys	kÃ¼chen
galleys	galeeren
yakovlev	jakowlew
simulators	simulatoren
kula	kula
albatros	albatros
afa	afa
railings	gelÃ¤nder
northridge	northridge
brough	brough
davos	davos
caesars	cÃ¤sar
caesars	caesars
grammars	grammatiken
overgrown	Ã¼berwuchert
ascoli	ascoli
evangelists	evangelisten
germaine	germaine
reba	reba
stetson	stetson
confessing	gesteht
confessing	gestehen
confessing	beichten
reshuffle	umbildung
polyhedron	polyeder
fille	fille
antiquaries	antiquaries
pancreas	bauchspeicheldrÃ¼se
belgians	belgier
schaumburg	schaumburg
gÃ¶del	gÃ¶del
lindgren	lindgren
hydroxyl	hydroxyl
nuno	nuno
snipers	scharfschÃ¼tzen
excesses	exzesse
nuova	nuova
verkhovna	werchowna
vapour	dampf
vapour	dÃ¤mpfe
vapour	dÃ¤mpfen
veritas	veritas
motherland	vaterland
motherland	mutterland
motherland	heimat
piedras	piedras
dello	dello
paleocene	palÃ¤ozÃ¤n
federalists	fÃ¶deralisten
ayutthaya	ayutthaya
adheres	haftet
bau	bau
mariam	mariam
busted	kaputt
busted	erwischt
philately	philatelie
kristine	kristine
acetic	essigsÃ¤ure
korda	korda
ogilvie	ogilvie
monogatari	monogatari
culminates	gipfelt
lajos	lajos
regio	regio
maier	maier
freitas	freitas
aleksey	alexei
cardigan	cardigan
cornwell	cornwell
cmos	cmos
zlÃ­n	zlÃ­n
ect	ect
kingman	kingman
dissimilar	unÃ¤hnlich
spiro	spiro
suspensions	aussetzung
kwang	kwang
shameless	unverschÃ¤mt
shameless	schamlos
cheapest	billigste
cheapest	gÃ¼nstigste
cheapest	billigsten
cheapest	gÃ¼nstigsten
guarani	guarani
sprites	sprites
bristow	bristow
dela	dela
flawless	tadellos
flawless	makellos
flawless	fehlerfrei
flawless	einwandfrei
carbonyl	carbonyl
krypton	krypton
aust	aust
borland	borland
disconnect	trennen
disconnect	abtrennen
disconnect	abschalten
spezia	spezia
merck	merck
bischoff	bischoff
lookup	nachschlagen
lookup	lookup
marchand	marchand
sweetness	sÃ¼ÃŸe
adelphi	adelphi
grinnell	grinnell
lillehammer	lillehammer
wellcome	wellcome
wellcome	willkommen
neurologist	neurologe
exegesis	exegese
dodgy	zwielichtige
splendor	pracht
jovanoviÄ‡	jovanoviÄ‡
bedding	betten
bedding	bettwÃ¤sche
jsc	jsc
fuzz	fuzz
risc	risc
acr	acr
mfk	mfk
gingrich	gingrich
orozco	orozco
orenburg	orenburg
kharkov	charkow
bypasses	umgeht
berkley	berkley
ato	ato
yaakov	yaakov
shotguns	gewehre
mtdna	mtdna
andrej	andrej
nid	nid
costas	costas
pharmacological	pharmakologische
pharmacological	pharmakologisch
pharmacological	pharmakologischen
arduous	anstrengend
arduous	beschwerlich
arduous	mÃ¼hsam
lista	lista
huns	hunnen
immaterial	unerheblich
immaterial	unwesentlich
thaksin	thaksin
ruud	ruud
myotis	myotis
boas	boas
integrative	integrativen
integrative	integrative
kilpatrick	kilpatrick
halliwell	halliwell
torrey	torrey
satisfactorily	zufriedenstellend
acyl	acyl
neutralize	neutralisieren
moya	moya
alcalÃ¡	alcalÃ¡
opengl	opengl
withhold	zurÃ¼ckzuhalten
withhold	zurÃ¼ckhalten
lem	lem
rtv	rtv
doon	doon
narcissus	narcissus
jeon	jeon
griffins	griffins
nederlandse	nederlandse
chrono	chrono
cranbrook	cranbrook
hardie	hardie
planks	bretter
humbert	humbert
beckman	beckman
plateaus	plateaus
pumas	pumas
mcclain	mcclain
pdr	pdr
ladislaus	ladislaus
wbo	wbo
extrasolar	extrasolaren
lundy	lundy
antietam	antietam
psalter	psalter
negligent	fahrlÃ¤ssig
negligent	nachlÃ¤ssig
hitomi	hitomi
stillman	stillman
prada	prada
norrkÃ¶ping	norrkÃ¶ping
digitised	digitalisiert
presto	presto
hairstyle	haarschnitt
hairstyle	frisur
goggles	brille
goggles	brillen
daewoo	daewoo
ecb	ezb
benÃ­tez	benÃ­tez
tcm	tcm
discharging	entladung
malhotra	malhotra
exhumed	exhumiert
sarnia	sarnia
cps	cps
stockwell	stockwell
carbondale	carbondale
timetables	fahrplÃ¤ne
timetables	fahrplan
proletariat	proletariats
christa	christa
cochabamba	cochabamba
swaps	swaps
swaps	swap
gaffney	gaffney
coelho	coelho
bronzes	bronzen
reciprocating	oszillierende
makin	makin
pylon	pylon
heber	heber
upanishads	upanishaden
remission	erlaÃŸ
remission	erlass
carrion	aas
homomorphism	homomorphismus
communicative	kommunikativen
machining	bearbeitung
machining	bearbeitungen
machining	metallbearbeitung
guetta	guetta
calorie	kalorien
shredder	shredder
git	git
synchronised	synchronisiert
heathen	heiden
caramel	karamell
clemency	gnade
benigno	benigno
inseparable	unzertrennlich
inseparable	untrennbar
ulcers	geschwÃ¼re
multivariate	multivariate
fondly	liebevoll
witte	witte
conversational	konversation
remuneration	entlohnung
remuneration	vergÃ¼tungen
remuneration	vergÃ¼tung
remuneration	entgelt
sokolov	sokolov
novell	novell
biel	biel
arie	arie
multiplicative	multiplikative
philippi	philippi
andros	andros
pca	pka
tsarist	zaristischen
tendered	ausgeschrieben
finalised	abgeschlossen
finalised	fertiggestellt
gabor	gabor
nlp	nlp
mooring	liegeplatz
ncl	ncl
zeitgeist	zeitgeist
xiongnu	xiongnu
velasquez	velasquez
farber	farber
czechoslovakian	tschechoslowakischen
hairdresser	friseur
glyphs	glyphen
twitch	twitch
twitch	zucken
shimbun	shimbun
contemplative	kontemplativen
sweetwater	sweetwater
godmother	patentante
brinkley	brinkley
circled	eingekreist
luster	glanz
luster	luster
bhupathi	bhupathi
xenia	xenia
gozo	gozo
hantuchovÃ¡	hantuchovÃ¡
nikolaos	nikolaos
desertion	desertion
beaks	schnÃ¤bel
rfu	rfu
unido	unido
scheming	intrigen
dammed	gestaut
vulgate	vulgata
neely	neely
peacemaker	friedensstifter
quantified	quantifiziert
quantified	beziffert
oper	oper
alasdair	alasdair
figurehead	galionsfigur
vaslui	vaslui
rbc	rbc
aoyama	aoyama
widths	breiten
widths	breite
embody	verkÃ¶rpern
strom	strom
strom	stroms
bde	bde
epicenter	epizentrum
manet	manet
ugh	ugh
ugh	pfui
ugh	uff
belgique	belgique
astragalus	astragalus
tatyana	tatjana
aguascalientes	aguascalientes
durante	durante
kath	kath
focke	focke
nimbus	nimbus
megumi	megumi
biarritz	biarritz
geeks	streber
geeks	geeks
stinger	stachel
stinger	stinger
pfalz	pfalz
colfax	colfax
kurgan	kurgan
xhosa	xhosa
tripping	stolpern
geforce	geforce
uthman	uthman
humayun	humayun
drenthe	drenthe
aberdare	aberdare
inquisitor	inquisitor
insurer	versicherungsgesellschaft
insurer	versicherer
perceptible	wahrnehmbar
universitatea	universitatea
raytheon	raytheon
cauca	cauca
deadlines	fristen
scavenger	plÃ¼nderer
barrichello	barrichello
conic	kegelschnitt
stepney	stepney
montauk	montauk
huckleberry	huckleberry
ribera	ribera
deville	deville
wikify	wikify
naoki	naoki
tinsley	tinsley
bystanders	umstehenden
bletchley	bletchley
cowen	cowen
vercelli	vercelli
baudelaire	baudelaire
balustrade	balustrade
ctc	ctc
byproduct	nebenprodukt
unskilled	ungelernte
scams	betrÃ¼gereien
scams	betrug
brontÃ«	brontÃ«
petrovich	petrowitsch
kendo	kendo
stoic	stoiker
gori	gori
unprofessional	unprofessionell
inflection	flexion
arnie	arnie
xiong	xiong
smelling	riechen
apprehend	fassen
groÃŸe	groÃŸe
joyous	freudig
joyous	freudigen
glycine	glycin
fjords	fjorde
rÃ©publique	rÃ©publique
beulah	beulah
uic	uic
sleigh	schlitten
pape	pape
transcendence	transzendenz
glade	glade
inventories	bestÃ¤nde
inventories	lagerbestÃ¤nde
inventories	aufstellungen
inventories	vorrÃ¤te
eisenstein	eisenstein
komi	komi
vander	vander
ganglion	ganglion
cession	abtretung
galvin	galvin
ansbach	ansbach
cristobal	cristobal
worsen	verschlechtern
worsen	verschlimmern
pusan	pusan
rupp	rupp
hammarby	hammarby
bradfield	bradfield
eurodance	eurodance
hsien	hsien
prva	prva
carnation	nelke
carnation	nelken
swenson	swenson
thad	thad
counteroffensive	gegenoffensive
weyl	weyl
minton	minton
wildflowers	wildblumen
prospero	prospero
teased	gehÃ¤nselt
adapters	adapter
channeled	kanalisiert
miri	miri
ruffin	ruffin
groovy	groovy
anatole	anatole
happiest	glÃ¼cklichste
happiest	glÃ¼cklichsten
ryszard	ryszard
ammonites	ammoniten
moderates	gemÃ¤ÃŸigten
moderates	gemÃ¤ÃŸigte
moderates	moderaten
pratchett	pratchett
minima	minima
amicably	gÃ¼tlich
accretion	akkretion
sihanouk	sihanouk
escola	escola
azusa	azusa
meara	meara
lita	lita
federaciÃ³n	federaciÃ³n
alstom	alstom
mrc	mrc
gambian	gambischen
yuko	yuko
brevis	brevis
nakayama	nakayama
isbns	isbns
faris	faris
unholy	unheilige
sovetov	sowetow
wittelsbach	wittelsbach
skylark	skylark
adl	adl
cutie	sÃ¼ÃŸer
adÄ±yaman	adÄ±yaman
knud	knud
fredrick	fredrick
rerun	wiederholung
zigzag	zickzack
ichiro	ichiro
menagerie	menagerie
wielkie	wielkie
kafelnikov	kafelnikow
interwoven	verwoben
interwoven	verflochten
mev	mev
pelÃ©	pelÃ©
haganah	hagana
laziness	trÃ¤gheit
laziness	faulheit
handbooks	handbÃ¼cher
handbooks	handbÃ¼chern
haru	haru
lockers	schrÃ¤nke
lockers	schlieÃŸfach
malpractice	miÃŸbrauch
malpractice	missbrauch
amidships	mittschiffs
ÄaÄak	ÄaÄak
farkas	farkas
evasive	ausweichen
evasive	ausweichend
compulsion	zwang
ncos	unteroffiziere
whiteley	whiteley
yousef	yousef
sophocles	sophokles
montparnasse	montparnasse
leiria	leiria
stasi	stasi
prepositions	prÃ¤positionen
jagiellonian	jagiellonen
cheong	cheong
graff	graff
standardisation	standardisierung
standardisation	vereinheitlichung
standardisation	normung
scythian	skythischen
conga	conga
lum	lum
dolph	dolph
aveyron	aveyron
kakheti	kachetien
nimoy	nimoy
matsudaira	matsudaira
ferraris	ferraris
megawatt	megawatt
darwen	darwen
ballistics	ballistik
overcomes	Ã¼berwindet
watercourse	wasserlauf
soot	ruÃŸ
neuroscientist	neurowissenschaftler
rowman	rowman
subprime	subprime
picts	pikten
bola	bola
frenchmen	franzosen
outgrowth	auswuchs
halstead	halstead
pacifists	pazifisten
everard	everard
alania	alanien
fogarty	fogarty
marl	marl
enquiries	anfragen
enquiries	nachfragen
hondo	hondo
giraud	giraud
ilona	ilona
whaler	walfÃ¤nger
frÃ¨res	frÃ¨res
leonards	leonards
snide	abfÃ¤lligen
crass	krass
murrow	murrow
effendi	effendi
onsen	onsen
islas	islas
lazare	lazare
aurelia	aurelia
repulsive	abstoÃŸend
pillsbury	pillsbury
mamie	mamie
amrita	amrita
chronically	chronisch
cavanaugh	cavanaugh
hasta	hasta
sma	sma
gallia	gallia
malfunctioning	fehlfunktion
malfunctioning	stÃ¶rung
flashy	auffÃ¤llig
hÃ©rcules	hÃ©rcules
berge	berge
dory	dory
luxor	luxor
frankford	frankford
sano	sano
kingstown	kingstown
coutts	coutts
cav	cav
cerebellum	kleinhirn
crediting	anrechnung
crediting	gutschrift
polaroid	polaroid
isotropic	isotrop
outweighs	Ã¼berwiegt
spatially	rÃ¤umlich
sherpa	sherpa
ovaries	eierstÃ¶cke
zuid	zuid
branca	branca
chulalongkorn	chulalongkorn
stoller	stoller
toshio	toshio
manitou	manitou
trincomalee	trincomalee
farouk	farouk
riau	riau
argeÈ™	argeÈ™
unsaturated	ungesÃ¤ttigten
snorri	snorri
seger	seger
disservice	bÃ¤rendienst
beaconsfield	beaconsfield
herzliya	herzlia
gwh	gwh
mladen	mladen
lilley	lilley
inhaled	eingeatmet
drucker	drucker
fairport	fairport
infantile	infantile
oars	ruder
oars	rudern
kamp	kamp
whitefield	whitefield
spandau	spandau
satyajit	satyajit
zor	zor
isolde	isolde
vouchers	gutscheine
vouchers	gutschein
syringe	spritzen
syringe	spritze
roms	roms
sadc	sadc
virulent	virulent
riker	riker
zacharias	zacharias
alphonso	alphonso
malmesbury	malmesbury
mexicali	mexicali
pender	pender
lacan	lacan
perrault	perrault
bendix	bendix
candelaria	candelaria
workspace	arbeitsflÃ¤che
workspace	arbeitsbereich
crystallization	kristallisation
factoring	factoring
tid	tid
cherish	schÃ¤tzen
aiba	aiba
mariko	mariko
pinckney	pinckney
sfc	sfc
ravines	schluchten
camouflaged	getarnt
keele	keele
tremolo	tremolo
malick	malick
acetone	aceton
bassano	bassano
moroder	moroder
recherches	recherches
fiqh	fiqh
overjoyed	Ã¼berglÃ¼cklich
bramble	bramble
hailey	hailey
founds	grÃ¼ndet
neutralized	neutralisiert
hÅjÅ	hÅjÅ
impure	unrein
hasselt	hasselt
jenni	jenni
handicraft	handarbeit
handicraft	kunsthandwerk
handicraft	handwerk
elen	elen
impassioned	leidenschaftliche
impassioned	leidenschaftlich
prejudicial	abtrÃ¤glich
overhanging	Ã¼berhÃ¤ngenden
parabola	parabel
matterhorn	matterhorn
watertight	wasserdicht
lipa	lipa
stockman	stockman
jebel	jebel
pettigrew	pettigrew
reachable	erreichbar
musculoskeletal	skelettmuskulatur
audax	audax
prichard	prichard
lurie	lurie
aldous	aldous
lidia	lidia
blouse	bluse
unflattering	unvorteilhaft
lire	lire
fergie	fergie
shijiazhuang	shijiazhuang
seconda	seconda
karolina	karolina
holmenkollen	holmenkollen
esau	esau
fittipaldi	fittipaldi
wessel	wessel
pth	pth
montt	montt
pix	pix
undertones	untertÃ¶nen
Å‚ukasz	Å‚ukasz
exacting	anspruchsvoll
bushfires	buschfeuer
murs	murs
ulu	ulu
raiden	raiden
zhan	zhan
soca	soca
fifi	fifi
princesa	princesa
trickery	tricks
pitfalls	fallstricke
dreamland	traumland
tema	tema
woodwinds	holzblasinstrumente
tseng	tseng
cirencester	cirencester
dasa	dasa
aeronautica	aeronautica
arica	arica
synchronize	synchronisierung
synchronize	abgleichen
synchronize	synchronisieren
scarring	narben
ronne	rÃ¶nne
komodo	komodo
juha	juha
columbo	columbo
chagall	chagall
inverter	wechselrichter
sulpice	sulpice
tonality	tonalitÃ¤t
grandin	grandin
glut	glut
suter	suter
booting	booten
brauer	brauer
sanctus	sanctus
papaya	papaya
nonesuch	nonesuch
teramo	teramo
newby	newby
axelrod	axelrod
irtysh	irtysch
politehnica	politehnica
cae	cae
generality	allgemeingÃ¼ltigkeit
sorin	sorin
saintes	saintes
serviceable	brauchbar
serviceable	brauchbaren
venizelos	venizelos
carcinogenic	karzinogen
carcinogenic	karzinogene
gente	gente
ostia	ostia
matsuyama	matsuyama
maxie	maxie
fart	furz
carswell	carswell
pec	pec
mashup	mashup
panoramas	panoramen
caster	caster
waive	verzichten
waive	absehen
pina	pina
pagasa	pagasa
hoshi	hoshi
cormier	cormier
cofactor	cofaktor
punctured	durchstochen
bidders	bieter
quds	quds
udall	udall
mikoÅ‚aj	mikoÅ‚aj
narcissism	narzissmus
belafonte	belafonte
koster	koster
fondo	fondo
kanto	kanto
jaques	jaques
ambrosia	ambrosia
firework	feuerwerk
merengue	merengue
adored	bewundert
adored	liebte
adored	verehrt
caÃ±as	caÃ±as
energized	eingeschaltet
cetinje	cetinje
biathlete	biathlet
predrag	predrag
joiner	tischler
redefining	neudefinition
breathless	atemlos
screamed	schrie
screamed	geschrien
constructivist	konstruktivistischen
bimbo	bimbo
remodel	umgestalten
viareggio	viareggio
oli	oli
slowdown	abschwung
slowdown	verlangsamen
slowdown	rÃ¼ckgang
slowdown	verlangsamung
slowdown	abschwÃ¤chung
estonians	esten
mÃ¡ximo	mÃ¡ximo
turbofan	turbofan
stratocaster	stratocaster
tondo	tondo
flammarion	flammarion
novikov	nowikow
bezirksliga	bezirksliga
wareham	wareham
montauban	montauban
inconspicuous	unauffÃ¤llig
resold	weiterverkauft
swarms	schwÃ¤rmen
swarms	schwÃ¤rme
steppenwolf	steppenwolf
tua	tua
aeon	aeon
callas	callas
biltmore	biltmore
tryptophan	tryptophan
rien	rien
metropolitano	metropolitano
wilhelmine	wilhelmine
reigate	reigate
aor	aor
kumanovo	kumanovo
dhl	dhl
bissell	bissell
meeks	meeks
aggressiveness	aggressivitÃ¤t
admiring	bewundern
maggio	maggio
cdi	cdi
westlife	westlife
angevin	angevinischen
poi	poi
spengler	spengler
collette	collette
summarises	fasst
gauche	gauche
nau	nau
titania	titania
nalbandian	nalbandian
foyt	foyt
calliope	calliope
boac	boac
sedative	beruhigungsmittel
kamara	kamara
disappoint	enttÃ¤uschen
stings	sticht
zulia	zulia
doorman	tÃ¼rsteher
doorman	portier
paterno	paterno
marquÃ©s	marquÃ©s
kamran	kamran
hams	schinken
anzio	anzio
dictatorships	diktaturen
poppies	mohn
carreÃ±o	carreÃ±o
tsukasa	tsukasa
hilversum	hilversum
meads	meads
berisha	berisha
agata	agata
conakry	conakry
sunnah	sunna
thuringian	thÃ¼ringischen
thuringian	thÃ¼ringer
titling	betitelung
wheelchairs	rollstuhl
wheelchairs	rollstuhlfahrer
wheelchairs	rollstÃ¼hle
shrinkage	schrumpfung
shrinkage	schrumpfen
hondt	hondt
carreras	carreras
macdonnell	macdonnell
stieglitz	stieglitz
tuc	tuc
nozzles	dÃ¼sen
gallegos	gallegos
maltin	maltin
lucent	lucent
weisman	weisman
arana	arana
faustino	faustino
gamla	gamla
alor	alor
szabo	szabo
reassured	beruhigt
seppi	seppi
culprits	schuldigen
culprits	Ã¼beltÃ¤ter
culprits	schuldige
nott	nott
americanus	americanus
marinas	hÃ¤fen
marinas	marinas
mages	magier
koren	koren
homesick	heimweh
pinheiro	pinheiro
drowns	ertrÃ¤nkt
drowns	ertrinkt
ojo	ojo
arriba	arriba
prerequisites	voraussetzung
prerequisites	voraussetzungen
prerequisites	bedingungen
prerequisites	grundvoraussetzungen
luba	luba
esgrima	esgrima
dede	dede
citrate	citrat
timm	timm
lage	lage
ustinov	ustinov
schwyz	schwyz
virulence	virulenz
ÄermÃ¡k	ÄermÃ¡k
aral	aral
longley	longley
neeson	neeson
stansfield	stansfield
tosa	tosa
saco	saco
ilia	ilia
somoza	somoza
ceauÈ™escu	ceauÈ™escu
stradivarius	stradivari
ens	ens
mothership	mutterschiff
waitakere	waitakere
erbil	erbil
lengua	lengua
amalfi	amalfi
heligoland	helgoland
bobbi	bobbi
copyleft	copyleft
predicates	prÃ¤dikate
hsing	hsing
bez	bez
insanely	wahnsinnig
unsupervised	unbeaufsichtigt
graciously	gnÃ¤dig
thermally	thermisch
bim	bim
faqs	faq
faqs	faqs
kurz	kurz
ratner	ratner
partenkirchen	partenkirchen
uzhhorod	uschhorod
juventude	juventude
lene	lene
karaman	karaman
brunet	brunet
conformance	Ã¼bereinstimmung
conformance	konformitÃ¤t
meagre	mager
meagre	mageren
meagre	dÃ¼rftig
etoile	etoile
tauris	tauris
silveira	silveira
shania	shania
phenyl	phenyl
bytom	bytom
pierrepont	pierrepont
merckx	merckx
albus	albus
nostradamus	nostradamus
vcr	videorekorder
ssg	ssg
psm	psm
imd	imd
joffre	joffre
troubadours	troubadours
minarets	minarette
diouf	diouf
hepworth	hepworth
kasumi	kasumi
mulla	mulla
lombardia	lombardei
guinevere	guinevere
authoritarianism	autoritarismus
crawled	kroch
retrofit	nachrÃ¼stung
retrofit	Ã¼berholung
retrofit	umrÃ¼stung
summerhill	summerhill
rafaela	rafaela
allyson	allyson
cuore	cuore
attainable	erreichbare
attainable	erreichbar
dubh	dubh
reay	reay
mayen	mayen
youngs	youngs
dandridge	dandridge
bullitt	bullitt
loka	loka
charleville	charleville
romy	romy
fragrances	dÃ¼fte
mdr	mdr
peppered	gespickt
mansa	mansa
sisi	sisi
selfishness	egoismus
makkah	mekka
educaciÃ³n	educaciÃ³n
natur	natur
asta	asta
falaise	falaise
antwerpen	antwerpen
palliser	palliser
ohno	Åno
stoppard	stoppard
naito	naito
metis	metis
renan	renan
aizu	aizu
mcginn	mcginn
crumbled	zerfiel
malaga	malaga
malaga	mÃ¡laga
nicolÃ²	nicolÃ²
painless	schmerzlos
anthers	staubbeutel
albanese	albanese
buttes	buttes
grete	grete
waregem	waregem
petrescu	petrescu
poder	poder
japon	japon
homogenous	homogene
homogenous	homogen
homogenous	homogenen
rsmc	rsmc
communis	communis
minuet	menuett
suvs	suvs
murmur	murmeln
quatro	quatro
oswaldo	oswaldo
pgc	pgc
rhaetian	rhÃ¤tische
urb	urb
hÃ¥kan	hÃ¥kan
brca	brca
storyboards	storyboards
amata	amata
metallicity	metallizitÃ¤t
doro	doro
nesbit	nesbit
wyclef	wyclef
supÃ©rieur	supÃ©rieur
rosser	rosser
malheur	malheur
aage	aage
condors	condors
olympiastadion	olympiastadion
amÃ©ricas	amÃ©ricas
printemps	printemps
follette	follette
telephoned	angerufen
guarda	guarda
gabler	gabler
hipper	hipper
knin	knin
tatsumi	tatsumi
hypo	hypo
gnr	gnr
elster	elster
ribeirÃ£o	ribeirÃ£o
fingerprinting	fingerabdrÃ¼cke
klitschko	klitschko
thetis	thetis
sperling	sperling
mandelbrot	mandelbrot
seaports	seehafen
seaports	seehÃ¤fen
bellona	bellona
bic	bic
hasidim	chassidim
manfredi	manfredi
fuqua	fuqua
zfc	zfc
retour	retour
wilbert	wilbert
buckshot	schrot
wallsend	wallsend
pascale	pascale
tami	tami
avoca	avoca
nicolet	nicolet
kerch	kertsch
bangui	bangui
ugric	ugrische
texting	sms
iai	iai
nobile	nobile
hori	hori
sak	sak
viol	gambe
deadlocked	festgefahren
dink	dink
salis	salis
nigga	nigger
nakai	nakai
rpc	rpc
fakir	fakir
rosemarie	rosemarie
sarma	sarma
uzi	uzi
pasa	pasa
smokin	smokin
linea	linea
glabra	glabra
wallin	wallin
sittard	sittard
kogan	kogan
masako	masako
neuer	neuer
camorra	camorra
tullio	tullio
alleviation	linderung
alleviation	milderung
tertullian	tertullian
barbora	barbora
ullrich	ullrich
zanuck	zanuck
neoclassicism	neoklassizismus
recklessly	leichtsinnig
lelouch	lelouch
monogamy	monogamie
acrocephalus	acrocephalus
omens	omen
omens	vorzeichen
threes	drei
threes	dreien
threes	dreier
bronfman	bronfman
ciarÃ¡n	ciarÃ¡n
carolus	carolus
switchboard	telefonzentrale
switchboard	zentrale
katsura	katsura
lsa	lsa
lavoisier	lavoisier
aalen	aalen
capa	capa
nyon	nyon
tailgate	heckklappe
mov	mov
theresia	theresia
tomic	tomic
documenta	documenta
parfitt	parfitt
proofreading	korrekturen
proofreading	korrekturlesen
proofreading	korrektur
electrocuted	stromschlag
fpga	fpga
hippolytus	hippolytos
chebyshev	tschebyschow
inedible	ungenieÃŸbar
mhnt	mhnt
resetting	zurÃ¼cksetzen
hipster	hipster
doan	doan
cyperus	cyperus
hardcastle	hardcastle
sturmbannfÃ¼hrer	sturmbannfÃ¼hrer
eod	eod
eppstein	eppstein
eubanks	eubanks
autosport	autosport
hanne	hanne
smits	smits
clotilde	clotilde
sternum	brustbein
tfs	tfs
mell	mell
suspends	aussetzt
scriabin	skrjabin
chapultepec	chapultepec
zagros	zagros
ludendorff	ludendorff
montalvo	montalvo
chÃ­	chÃ­
bartoszyce	bartoszyce
sandburg	sandburg
bgm	bgm
florist	floristen
eÃ¶tvÃ¶s	eÃ¶tvÃ¶s
schaller	schaller
keke	keke
ahram	ahram
laa	laa
stn	stn
borno	borno
hite	hite
cheatham	cheatham
lamprey	neunaugen
pizzeria	pizzeria
hibernate	hibernate
kufa	kufa
oyama	oyama
hydraulically	hydraulisch
welf	welfen
jinn	dschinn
jinn	ginn
ager	ager
resp	bzw
uninhabitable	unbewohnbar
hauer	hauer
andrija	andrija
dumpster	mÃ¼lltonne
palenque	palenque
pluralistic	pluralistischen
popstars	popstars
admira	admira
haughty	Ã¼berheblich
lundin	lundin
berton	berton
passos	passos
kenzo	kenzo
prelature	prÃ¤latur
misappropriation	veruntreuung
macerata	macerata
amores	amores
joinery	schreinerei
varner	varner
olmert	olmert
bms	bms
patrese	patrese
tanabe	tanabe
protectionism	protektionismus
sisu	sisu
strutt	strutt
underlines	unterstreicht
groundhog	murmeltier
pisano	pisano
montag	montag
ferruginea	ferruginea
npd	npd
avoidable	vermeidbare
gratis	gratis
gratis	unentgeltlich
odawara	odawara
superconductors	supraleiter
sacrum	sacrum
fixated	fixiert
brocade	brokat
arachnida	arachnida
Å¾ÄÃ¡r	Å¾ÄÃ¡r
eyewear	sonnenbrillen
concierto	concierto
motilal	motilal
pompadour	pompadour
irritate	reizen
myrrh	myrrhe
sunt	sunt
alkan	alkan
stedelijk	stedelijk
connemara	connemara
swa	swa
buttermilk	buttermilch
fillers	fÃ¼llstoffe
attilio	attilio
Ã¥rhus	aarhus
Ã¥rhus	Ã¥rhus
paik	paik
kirchhoff	kirchhoff
mielec	mielec
transmutation	transmutation
karimi	karimi
shrill	schrille
jabez	jabez
hov	hov
publica	publica
humanitas	humanitas
roadblocks	straÃŸensperren
zarzuela	zarzuela
ecce	ecce
calabrese	calabrese
sanat	sanat
herpetologist	herpetologe
companhia	companhia
parmentier	parmentier
mcas	wab
stupas	stupas
jerrold	jerrold
proudhon	proudhon
golda	golda
btc	btc
pindar	pindar
standardise	vereinheitlichen
standardise	standardisieren
creston	creston
badass	krass
smÃ¥land	smÃ¥land
funnier	lustiger
rages	tobt
pique	pique
vocoder	vocoder
mouscron	mouscron
bott	bott
landi	landi
barbs	widerhaken
basilisk	basilisk
vivi	vivi
thalberg	thalberg
fetching	holen
fetching	abrufen
simson	simson
zastava	zastava
icarly	icarly
klas	klas
brisco	brisco
myopia	kurzsichtigkeit
bork	bork
llosa	llosa
landy	landy
nefertiti	nofretete
brianza	brianza
roches	roches
clairvaux	clairvaux
odenwald	odenwald
halla	halla
listy	listy
nef	nef
steinhardt	steinhardt
reinach	reinach
callender	callender
wenceslas	wenzel
vit	vit
robs	berauben
robs	raubt
villon	villon
oun	oun
dismemberment	zerstÃ¼ckelung
aub	aub
mahabad	mahabad
eyal	eyal
vrije	vrije
colliers	colliers
kundalini	kundalini
saku	saku
bijou	bijou
shirai	shirai
breathes	atmet
nomi	nomi
kasem	kasem
teu	euv
teu	teu
beals	beals
fracking	fracking
inka	inka
assi	assi
variegata	variegata
amazonia	amazonien
istres	istres
tavernier	tavernier
bÃ¶hme	bÃ¶hme
alde	alde
zamoyski	zamoyski
usury	wucher
vips	vips
beek	beek
dau	dau
guilin	guilin
rsp	rsp
gongs	gongs
rondÃ´nia	rondÃ´nia
unease	unbehagen
europÃ©enne	europÃ©enne
deportees	deportierten
fada	fada
celaya	celaya
barcelos	barcelos
housework	hausarbeit
aparicio	aparicio
eggleston	eggleston
viera	viera
yokota	yokota
Ã¡dÃ¡m	Ã¡dÃ¡m
borbÃ³n	borbÃ³n
uusimaa	uusimaa
cristoforo	cristoforo
martti	martti
basalts	basalte
henares	henares
transversal	transversale
barzani	barzani
reciprocate	erwidern
ÅŸahin	ÅŸahin
uca	uca
grandnephew	groÃŸneffe
arcturus	arcturus
tsp	tl
tsp	tsp
freckles	sommersprossen
hosseini	hosseini
mutsu	mutsu
dendrites	dendriten
gianna	gianna
smet	smet
unbeatable	unschlagbar
spiritus	spiritus
hellmuth	hellmuth
billancourt	billancourt
amÃ©rique	amÃ©rique
thammarat	thammarat
wartburg	wartburg
esparza	esparza
kord	kord
cognomen	cognomen
volterra	volterra
vtol	vtol
goulart	goulart
liquidate	liquidiert
liquidate	liquidieren
uld	uld
yara	yara
masaya	masaya
numidia	numidien
apostol	apostol
copyist	kopist
smallholders	kleinbauern
dominika	dominika
galatians	galater
profitably	profitabel
profitably	gewinnbringend
kawakami	kawakami
nyÃ­regyhÃ¡za	nyÃ­regyhÃ¡za
curtius	curtius
ots	ots
redness	rÃ¶tung
moniz	moniz
uas	uas
fru	fru
neutralization	neutralisierung
margarethe	margarethe
denigrate	verunglimpfen
kad	kad
transducers	wandler
malatya	malatya
frÃ¨re	frÃ¨re
laurentiis	laurentiis
yami	yami
primorje	primorje
lushan	lushan
molnÃ¡r	molnÃ¡r
romina	romina
breviary	brevier
unctad	unctad
pozzi	pozzi
amphora	amphora
classique	classique
chewbacca	chewbacca
dolittle	dolittle
fairlight	fairlight
backwaters	altwasser
phlox	phlox
catena	catena
wickedness	schlechtigkeit
wickedness	bosheit
scipione	scipione
laurentius	laurentius
kerberos	kerberos
temuco	temuco
turgut	turgut
rattlesnakes	klapperschlangen
breck	breck
shitty	beschissen
manstein	manstein
molitor	molitor
benefices	pfrÃ¼nde
yugoslavs	jugoslawen
einsatzgruppen	einsatzgruppen
diptych	diptychon
takasaki	takasaki
kem	kem
alexandrina	alexandrina
goodbyes	abschied
splendens	splendens
lts	lts
basilicas	basiliken
ivrea	ivrea
sultanates	sultanate
agnelli	agnelli
plp	plp
donja	donja
aegina	aigina