aqua	aqua
agatha	agatha
culpabilidad	guilt
culpabilidad	culpability
ucm	ucm
estrictas	strict
compositae	compositae
ureÃ±a	ureÃ±a
conducidos	driven
muriel	muriel
erizo	urchin
erizo	hedgehog
comparando	comparing
teodorico	theodoric
coello	coello
tragedias	tragedies
esmirna	smyrna
premisas	premises
temperley	temperley
valladares	valladares
impedido	prevented
impedido	impeded
bromeliaceae	bromeliaceae
gauchos	gauchos
nur	nur
desarrollÃ¡ndose	developing
secuestra	kidnaps
litÃºrgico	liturgical
ocre	ochre
exclusividad	exclusive
exclusividad	exclusivity
caÃ±os	pipes
ultimÃ¡tum	ultimatum
bautizados	baptised
bautizados	baptized
bloody	bloody
jankoviÄ‡	jankoviÄ‡
cinc	zinc
educada	educated
matador	killer
matador	matador
juanita	juanita
moncayo	moncayo
intensivo	intensive
notado	noted
notado	noticed
problemÃ¡tico	troublesome
problemÃ¡tico	problematic
implementaciones	implementations
aosta	aosta
figueres	figueres
orson	orson
costello	costello
convecciÃ³n	convection
desplazar	scroll
desplazar	displace
aziz	aziz
urales	ural
urales	urals
thorne	thorne
contemplaba	contemplated
colaborativo	collaborative
pennetta	pennetta
bartolo	bartolo
hickman	hickman
dualidad	duality
indudablemente	unquestionably
indudablemente	undoubtedly
villarroel	villarroel
rip	rip
apetito	appetite
buitrago	buitrago
bali	bali
lider	leader
envenenado	poisoned
zumo	juice
innovadoras	innovators
innovadoras	innovative
agresivos	aggressive
comprendiendo	understanding
krishna	krishna
infusiÃ³n	infusion
tutorial	tutorial
bhupathi	bhupathi
pearce	pearce
conectores	connectors
inhibe	inhibit
inhibe	inhibits
caÃ­n	cain
donar	donating
donar	donate
engaÃ±ado	fooled
engaÃ±ado	tricked
engaÃ±ado	cheated
engaÃ±ado	deceived
fracasar	fail
bipolar	bipolar
contenidas	contained
detectÃ³	detected
embarazadas	expectant
embarazadas	pregnant
revelada	revealed
aureliano	aureliano
interscope	interscope
pereda	pereda
arbitrarias	arbitrary
riviera	riviera
autorizadas	authorised
autorizadas	authorized
amenazar	threaten
amenazar	threatening
imita	mimics
imita	imitate
imita	imitates
madrina	godmother
transistores	transistor
transistores	transistors
refracciÃ³n	refraction
leguminosae	leguminosae
sofisticado	sophisticated
colector	manifold
colector	collector
blaine	blaine
moderne	moderne
soon	soon
pga	pga
mandolina	mandolin
compartidas	shared
rochelle	rochelle
twain	twain
desesperadamente	desperately
desesperadamente	hopelessly
juba	juba
reposterÃ­a	bakery
reposterÃ­a	confectionery
reposterÃ­a	pastry
reposterÃ­a	pastries
locus	locus
waffen	waffen
sada	sada
sÃºbita	sudden
ferreyra	ferreyra
otorgando	granting
vogel	vogel
mediocre	mediocre
detectores	detectors
encrucijada	crossroad
encrucijada	crossroads
tordesillas	tordesillas
morella	morella
cobb	cobb
consagrados	enshrined
consagrados	consecrated
savoy	savoy
bolt	bolt
televisiones	televisions
televisiones	television
televisiones	tvs
mcmillan	mcmillan
jueza	judge
simancas	simancas
nieminen	nieminen
interminable	unending
interminable	interminable
interminable	endless
roubaix	roubaix
gilmour	gilmour
antonov	antonov
summa	summa
cpc	cpc
comprensible	comprehensible
comprensible	understandable
contemplaciÃ³n	contemplation
narrativas	narratives
drag	drag
axiomas	axioms
filipinos	filipinos
filipinos	filipino
violando	violating
violando	raping
jacinta	jacinta
vfl	vfl
concord	concord
phineas	phineas
carrara	carrara
jess	jess
logias	lodges
usurpador	usurper
sorpresas	surprises
olfato	olfactory
olfato	smell
internacionalizaciÃ³n	internationalization
internacionalizaciÃ³n	internationalisation
prefecturas	prefectures
biographie	biographie
hemoglobina	hemoglobin
hemoglobina	haemoglobin
sap	sap
hospitalidad	hospitality
infidelidad	infidelity
oria	oria
hunos	huns
jarrett	jarrett
hua	hua
bata	gown
bata	robe
bata	bathrobe
bata	bata
convergen	converge
senecio	senecio
psa	psa
dea	dea
shun	shun
venture	venture
altavoz	loudspeaker
altavoz	speaker
longew	longew
ibÃ­d	ibid
bulldog	bulldog
purpurea	purpurea
dixie	dixie
pesadillas	nightmares
chipriota	cypriot
asociar	associate
asociar	associating
venenosa	poisonous
venenosa	venomous
boulder	boulder
craven	craven
bsd	bsd
sanguinetti	sanguinetti
grandis	grandis
ramificaciÃ³n	branching
dormida	asleep
dormida	sleeping
carcasa	housing
carcasa	casing
goÃ±i	goÃ±i
edberg	edberg
juli	juli
tibet	tibet
cheshire	cheshire
irritaciÃ³n	irritation
rutinas	routines
palustris	palustris
beas	beas
yemas	buds
yemas	fingertips
yemas	yolks
racine	racine
simÃ©trico	symmetric
simÃ©trico	symmetrical
ternura	cuteness
ternura	tenderness
genoveses	genoese
prejuicio	prejudice
machete	machete
stf	stf
communis	communis
convenientemente	conveniently
aislante	insulation
aislante	insulating
subgrupos	subgroups
mitrÃ­dates	mithridates
iec	iec
pandemia	pandemic
tato	tato
esporÃ¡dica	sporadic
esporÃ¡dica	sporadically
millidge	millidge
realizaciones	achievements
realizaciones	accomplishments
tableros	panels
tableros	boards
alcoholes	alcohol
alcoholes	alcohols
llamativa	showy
llamativa	flashy
utrera	utrera
descriptivo	descriptive
carroza	chariot
carroza	carriage
carroza	float
carroza	hearse
acreditados	accredited
mayenne	mayenne
racistas	racists
racistas	racist
decididamente	decidedly
desempleados	unemployed
remuneraciÃ³n	remuneration
arcadas	arcades
arcadas	gagging
graduada	graduated
lyle	lyle
ugo	ugo
fisio	physio
sampson	sampson
hipoteca	mortgages
hipoteca	mortgage
probando	testing
probando	trying
decidiendo	deciding
vers	vers
coda	coda
saratoga	saratoga
fax	fax
pasear	walking
pasear	stroll
implantado	implanted
kriegsmarine	kriegsmarine
primate	primate
elk	elk
elk	kla
roadrunner	roadrunner
regionalliga	regionalliga
milonga	milonga
vaginal	vaginal
bondarenko	bondarenko
caseta	doghouse
remy	remy
mÃ©tricas	metrics
mÃ©tricas	metric
megumi	megumi
aveyron	aveyron
bernarda	bernarda
carnÃ­voro	carnivore
carnÃ­voro	carnivorous
filho	filho
creÃ­do	believed
cibeles	cybele
concolor	concolor
shepard	shepard
niko	niko
gateway	gateway
bisbal	bisbal
gÃ¼nter	gÃ¼nter
haus	haus
gros	gros
hayek	hayek
lexus	lexus
kingsley	kingsley
retardo	delay
tintas	inks
tintas	ink
mifflin	mifflin
vivar	vivar
esfinge	sphinx
tama	tama
garnier	garnier
sestao	sestao
coen	coen
carreta	wagon
carreta	cart
uniformemente	uniformly
uniformemente	evenly
tabarÃ©	tabarÃ©
tubÃ©rculo	tuber
jÃºbilo	jubilee
narradores	storytellers
kanagawa	kanagawa
gastronÃ³mico	gastronomic
marsupiales	marsupials
impopular	unpopular
ryukyu	ryukyu
auspicios	auspices
pinocho	pinocchio
gandalf	gandalf
harcourt	harcourt
consecutivamente	consecutively
descartada	discarded
tap	tap
disfrazados	costumed
disfrazados	disguised
emotivo	emotive
emotivo	emotional
cilicia	cilicia
inquilinos	renters
inquilinos	tenants
inquilinos	tenant
yvelines	yvelines
confesar	confessing
confesar	confess
madden	madden
subunidad	subunit
atmosfÃ©ricas	atmospheric
alberca	pool
retenido	retained
retenido	withheld
inferencia	inference
harms	harms
mcgregor	mcgregor
mcgregor	macgregor
paranoia	paranoid
paranoia	paranoia
sartÃ©n	skillet
sartÃ©n	pan
recÃ­proca	reciprocal
contestaciÃ³n	reply
fabrice	fabrice
jurÃ­dicamente	legally
ricamente	richly
cesaron	ceased
transgÃ©nero	transgender
lilian	lilian
kyo	kyo
fascinado	fascinated
desarrolle	develop
pÃ©simo	lousy
bardo	bardo
bardo	bard
sava	sava
desplazada	displaced
imaginarios	imaginary
cuidadoso	careful
banquetes	banquets
banquetes	banquet
hrs	hrs
forÃªt	forÃªt
uchiha	uchiha
cotizaciÃ³n	quote
cotizaciÃ³n	quotation
expresados	expressed
albus	albus
inaugurar	inaugurate
christchurch	christchurch
nascimento	nascimento
noemÃ­	noemÃ­
televisado	televised
sinceridad	sincerity
sinceridad	honesty
ying	ying
fructÃ­fera	fruitful
kata	kata
costosos	costly
Ã³ptimas	optimal
Ã³ptimas	optimum
deprimido	depressed
olores	odors
olores	smells
bombero	firefighter
bombero	fireman
dalla	dalla
fms	fms
antÃ­doto	antidote
llibre	llibre
destructivo	destructive
nfc	nfc
leonora	leonora
bellucci	bellucci
densidades	densities
voor	voor
peri	peri
arnoldo	arnoldo
groupe	groupe
tse	tse
altitudinal	altitudinal
motivados	motivated
arrastrar	drag
arrastrar	dragging
apr	apr
criadores	breeder
criadores	breeders
chow	chow
lii	lii
ginecologÃ­a	gynaecology
golondrinas	swallows
orgullosa	proud
krusty	krusty
scrophulariaceae	scrophulariaceae
jÃ¶rg	jÃ¶rg
esquipulas	esquipulas
curiosas	curious
ausencias	absences
epidermis	epidermis
interpretativa	interpretative
interpretativa	interpretive
ancud	ancud
divergentes	diverging
divergentes	divergent
giselle	giselle
dim	dim
encyclopÃ¦dia	encyclopÃ¦dia
rutgers	rutgers
caribeÃ±o	caribbean
estudis	estudis
anticipado	anticipated
violante	violante
rosetta	rosetta
clavel	carnation
interactÃºa	interact
interactÃºa	interacts
fielding	fielding
tomentosa	tomentosa
marais	marais
pipino	pepin
wikia	wikia
robustos	robust
anubis	anubis
ntsc	ntsc
antorchas	torches
mesnil	mesnil
fukushima	fukushima
Ã¡caros	mites
contaminado	polluted
contaminado	tainted
contaminado	contaminated
piauÃ­	piauÃ­
nuovo	nuovo
paok	paok
reiniciar	reset
reiniciar	reboot
reiniciar	restart
guru	guru
huari	huari
castlevania	castlevania
victorio	victorio
nazario	nazario
imperfecto	imperfect
chato	chato
interpol	interpol
longitudinalmente	lengthwise
duomo	duomo
policarpo	policarpo
bne	bne
morgana	morgana
morgana	morgan
nicaragÃ¼enses	nicaraguans
dolares	dollars
ecm	ecm
fce	fce
acumulados	accrued
acumulados	accumulated
ducas	doukas
hemorragias	bleeding
mauna	mauna
expresividad	expressiveness
stardust	stardust
psicoanalÃ­tica	psychoanalytic
antipapa	antipope
locomociÃ³n	locomotion
figurado	figurative
figurado	figuratively
votando	voting
apolonio	apollonius
sela	sela
conferenciante	lecturer
tico	tico
kiribati	kiribati
archiv	archiv
beatty	beatty
reunion	reunion
hlasek	hlasek
ilustran	illustrate
aulo	aulus
ambiciosos	ambitious
experimentalmente	experimentally
folclorista	folklorist
sfondo	sfondo
chilpancingo	chilpancingo
nicÃ©foro	nikephoros
mani	mani
atmosfÃ©ricos	atmospheric
historicista	historicist
baÃ±era	tub
baÃ±era	bathtub
baÃ±era	bath
huasteca	huasteca
colom	colom
despedidos	fired
despedidos	dismissed
agresor	attacker
agresor	assailant
agresor	aggressor
maternal	motherly
maternal	maternal
volÃ¡tiles	volatile
mentiroso	liar
gladiador	gladiator
desliza	slide
desliza	swipe
barraca	hut
barraca	barracks
barraca	barrack
bernadette	bernadette
maturana	maturana
lacan	lacan
propensos	prone
venenoso	poisonous
venenoso	venomous
breslau	breslau
sykes	sykes
comique	comique
jenofonte	xenophon
jasmine	jasmine
vermeer	vermeer
cÃ³nyuges	spouses
clijsters	clijsters
esplÃ©ndida	splendid
wisin	wisin
idiosincrasia	idiosyncrasy
wilcox	wilcox
tormento	torment
gargantas	gorges
gargantas	throats
cableado	cabling
cableado	wiring
cableado	wired
barricadas	roadblocks
barricadas	barricade
barricadas	barricades
fil	fil
barraza	barraza
sordera	deafness
pembroke	pembroke
aplauso	applause
antalya	antalya
escribas	scribes
interludio	interlude
tarantino	tarantino
cÃ©zanne	cÃ©zanne
despiadado	ruthless
despiadado	heartless
despiadado	merciless
conjuro	conjuring
conjuro	incantation
conjuro	spell
conjuro	sorcery
conjuro	conjure
condolencias	condolences
condolencias	sympathy
condolencias	condolence
henin	henin
angraecum	angraecum
gia	gia
marsupial	marsupial
dÃºrcal	dÃºrcal
cmb	cmb
blizzard	blizzard
vernÃ¡cula	vernacular
exo	exo
agarrar	grab
consultores	consultants
bettina	bettina
deponer	depose
garrote	club
hitomi	hitomi
revueltos	scrambled
dynamic	dynamic
solsona	solsona
incoloro	colourless
incoloro	colorless
esparto	esparto
donnie	donnie
husayn	husayn
argento	argento
solemnemente	solemnly
ovaciÃ³n	ovation
gba	gba
fresas	strawberries
fresas	mills
geneviÃ¨ve	geneviÃ¨ve
offenbach	offenbach
retribuciÃ³n	retribution
retribuciÃ³n	remuneration
elongata	elongata
montreuil	montreuil
pinal	pinal
maarten	maarten
incorrectas	incorrect
circulante	circulating
irÃ³nica	ironic
urrea	urrea
insÃ³lito	unusual
insÃ³lito	unheard
codorniz	quail
rosset	rosset
tko	tko
petrarca	petrarch
oftalmologÃ­a	ophthalmology
taira	taira
wendigo	wendigo
malabo	malabo
indiano	indiano
uttar	uttar
imparcialidad	impartial
imparcialidad	impartiality
imparcialidad	fairness
areco	areco
diem	diem
saunier	saunier
dandy	dandy
estÃ©ticamente	aesthetically
duhalde	duhalde
cerebrovascular	cerebrovascular
advocaciones	advocation
zachary	zachary
moras	berries
moras	blackberries
mises	mises
jeunesse	jeunesse
kÃ¶hler	kÃ¶hler
petro	petro
rosy	rosie
rosy	rosy
acentuada	accentuated
sebastiÃ£o	sebastiÃ£o
keck	keck
speer	speer
maleta	suitcase
dep	dep
dep	dept
dep	rip
lombard	lombard
polla	dick
polla	cock
divisor	splitter
divisor	divider
dictan	dictate
bufo	bufo
pluralismo	pluralism
estÃ¡ticas	static
llorens	llorens
pubs	pubs
usurpaciÃ³n	usurpation
profesionalizaciÃ³n	professionalization
doubleday	doubleday
caine	caine
kyoko	kyoko
jornal	jornal
entomologÃ­a	entomology
androides	androids
androides	droids
oni	oni
groningen	groningen
forenses	forensic
forenses	forensics
velez	velez
murakami	murakami
electroacÃºstica	electroacoustic
contratiempos	setbacks
contratiempos	mishaps
ionizaciÃ³n	ionization
gustaf	gustaf
focke	focke
panteras	panthers
paradiso	paradiso
escapada	breakaway
escapada	escapade
escapada	getaway
escapada	escape
lvii	lvii
descalzo	barefoot
govaerts	govaerts
charpentier	charpentier
grabb	grabb
miren	look
chesterfield	chesterfield
arcipreste	archpriest
egidio	egidio
mila	mila
sylar	sylar
grewia	grewia
formalismo	formalism
factbook	factbook
botanische	botanische
tamarindo	tamarindo
mecÃ¡nicamente	mechanically
mizuki	mizuki
jimbo	jimbo
angelus	angelus
lviii	lviii
escoltas	escorts
escoltas	escort
mutuos	mutual
objetivamente	objectively
sangrientos	gory
sangrientos	bloody
veloso	veloso
caninos	canines
acudiendo	flocking
jozef	jozef
lilium	lilium
planteadas	raised
formulaciones	formulations
reciprocidad	reciprocal
reciprocidad	reciprocity
balfour	balfour
skrull	skrull
sincronizado	synced
sincronizado	synchronised
sincronizado	synchronized
tectÃ³nicas	tectonic
contras	contras
contras	cons
contras	contra
limburgo	limburg
identificable	identifiable
chota	chota
lisp	lisp
tabernÃ¡culo	tabernacle
alix	alix
macgregor	macgregor
ollanta	ollanta
discutieron	argued
massÃº	massÃº
gta	gta
pel	pel
cotopaxi	cotopaxi
visiblemente	visibly
visiblemente	conspicuously
winslow	winslow
vivida	lived
alertas	alerts
alertas	alert
ppc	ppc
ppc	cfp
interruptores	switches
gillan	gillan
anglia	anglia
jimeno	jimeno
drones	drone
drones	drones
bobinas	coils
bobinas	rolls
bobinas	reels
delft	delft
ursae	ursae
django	django
galante	gallant
informante	informer
informante	informant
kof	kof
freestyle	freestyle
llagas	sores
inyecta	injects
reclasificaciÃ³n	reclassification
helÃ©nica	hellenic
swami	swami
alia	alia
gym	gym
consensuado	consensual
cibulkovÃ¡	cibulkovÃ¡
amato	amato
indomable	indomitable
mercier	mercier
reactivar	reactivate
hemisferios	hemispheres
mojado	wet
knuth	knuth
baikal	baikal
brindis	toast
brindis	toasts
califas	caliphs
baz	baz
guillotina	guillotine
fishbase	fishbase
ineficaz	ineffective
ineficaz	inefficient
mandamiento	commandment
pentatlÃ³n	pentathlon
homologaciÃ³n	approval
sellada	sealed
tÃ¼bingen	tÃ¼bingen
ard	ard
daft	daft
vendedora	seller
excelsa	excelsa
unica	unique
completados	completed
donnelly	donnelly
genomas	genomes
cavar	dig
cavar	digging
laponia	lapland
picota	pillory
sijismo	sikhism
ame	ames
ame	ame
burnham	burnham
alegato	pleading
mamas	mamas
interdisciplinario	interdisciplinary
durado	lasted
openoffice	openoffice
plantada	jilted
plantada	planted
moho	mould
moho	mildew
moho	mold
laguardia	laguardia
hime	hime
incertae	incertae
gianfranco	gianfranco
longa	longa
tripartita	tripartite
lusignan	lusignan
sanford	sanford
reubicaciÃ³n	relocation
rodeos	rodeo
hut	hut
inaccesibles	inaccessible
tripulada	manned
garbo	garbo
mita	mita
bigotes	mustaches
bigotes	moustache
bigotes	whiskers
bigotes	mustache
sumerio	sumerian
granma	granma
almorÃ¡vide	almoravid
ratifica	ratify
leucocitos	leukocytes
cayetana	cayetana
formalizar	formalize
formalizar	formalizing
escopetas	shotguns
erythrina	erythrina
liar	liar
asados	roasted
braxton	braxton
islandeses	icelandic
parabellum	parabellum
garfio	hook
almacenadas	stockpiled
almacenadas	stored
investigados	investigated
invirtiendo	investing
sobrepasado	overstepped
sobrepasado	exceeded
sobrepasado	surpassed
cni	cni
viet	viet
sÃ¡ndor	sÃ¡ndor
menezes	menezes
dessau	dessau
hesÃ­odo	hesiod
gwynedd	gwynedd
organizacion	organization
organizacion	organisation
buga	buga
comfort	comfort
revelados	revealed
wesker	wesker
battaglia	battaglia
gora	gora
locuras	follies
locuras	craziness
barÃ³	barÃ³
bombonera	bombonera
bocadillo	snack
bocadillo	sandwich
huntingdon	huntingdon
peludo	hairy
peludo	furry
adamson	adamson
auct	auct
montaÃ±eros	mountaineers
cuellos	necks
cuellos	collars
honneur	honneur
sync	sync
ting	ting
dinah	dinah
manipula	manipulates
facies	facies
cenas	dinners
cenas	dinner
metafÃ­sico	metaphysical
berrer	berrer
ashford	ashford
visceral	visceral
arthurs	arthurs
humbert	humbert
rts	rts
christo	christo
rimski	rimsky
destrezas	skills
majadahonda	majadahonda
precepto	precept
ise	ise
ovw	ovw
pokemon	pokemon
escayola	plaster
veil	veil
flavonoides	flavonoids
dressler	dressler
avestruz	ostrich
balÃ¡zs	balÃ¡zs
estructurados	structured
varona	varona
miz	miz
hasbro	hasbro
tololo	tololo
blau	blau
desafiando	challenging
desafiando	defying
alatriste	alatriste
meryl	meryl
blackwood	blackwood
legitimaciÃ³n	legitimacy
legitimaciÃ³n	legitimizing
trier	trier
dauban	dauban
narcÃ³ticos	narcotic
narcÃ³ticos	narcotics
spinoza	spinoza
deseadas	desired
cornus	cornus
recortada	cropped
tungurahua	tungurahua
cougar	cougar
kÃ³rsakov	korsakov
invocando	invoking
pavos	turkeys
spadea	spadea
suh	suh
mustaine	mustaine
cubillas	cubillas
bÃ¡ltica	baltic
representatividad	representativeness
representatividad	representative
wÃ¼rzburg	wÃ¼rzburg
marsden	marsden
alenÃ§on	alenÃ§on
varzim	varzim
factorizaciÃ³n	factorization
timidez	shyness
timidez	timidity
iza	iza
lemus	lemus
intestinos	bowels
intestinos	bowel
intestinos	intestine
intestinos	intestines
sel	sel
clarinetes	clarinets
bangor	bangor
cÃ¡nceres	cancers
cypripedium	cypripedium
aron	aron
cosmÃ³dromo	cosmodrome
capullo	cocoon
gulag	gulag
mÃ©jico	mexico
paoli	paoli
sobreviviendo	surviving
fife	fife
recaudaciones	fundraisers
intertropical	intertropical
apodaca	apodaca
stavanger	stavanger
corella	corella
horthy	horthy
notarios	notaries
gaertn	gaertn
dalt	dalt
drysdale	drysdale
cuantitativos	quantitative
aquaman	aquaman
henrietta	henrietta
rallado	shredded
rallado	grated
itÅ	itÅ
capitulo	chapter
cane	cane
izzy	izzy
reveses	setbacks
reveses	reversals
reveses	reverses
carracci	carracci
abolicionista	abolitionist
ipcc	ipcc
pabÃ³n	pabÃ³n
diddy	diddy
ralston	ralston
estupefacientes	narcotic
estupefacientes	narcotics
champÃ¡n	champagne
tarÃ³czy	tarÃ³czy
tonterÃ­a	nonsense
mahdi	mahdi
incorrectos	incorrect
transducciÃ³n	transduction
arcoÃ­ris	rainbow
fundamentado	substantiated
pcp	pcp
pcp	cfp
enya	enya
stratovarius	stratovarius
hoshi	hoshi
jambas	jambs
crespi	crespi
impresionados	impressed
geodÃ©sico	geodetic
enduro	enduro
paganini	paganini
funcionaria	official
halford	halford
treehouse	treehouse
hyatt	hyatt
improvisar	improvise
improvisar	improvising
improvisar	improv
nola	nola
monoplano	monoplane
renegado	renegade
winnebago	winnebago
sonja	sonja
bandicoot	bandicoot
jal	jal
condicionamiento	conditioning
mouton	mouton
boyce	boyce
Ã©vÃªque	Ã©vÃªque
solidarios	solidarity
despejado	clear
despejado	cleared
batavia	batavia
incita	incites
coacciÃ³n	compulsion
coacciÃ³n	coercion
coacciÃ³n	duress
indeseables	undesirable
sonado	sounded
sonado	rung
reafirma	reaffirms
gakuen	gakuen
udc	udc
aram	aram
faustina	faustina
posponer	postpone
olvidando	forgetting
netscape	netscape
bennington	bennington
colombina	colombina
baÃ±istas	bathers
intensifica	intensify
intensifica	intensifies
gorilas	gorillas
gorilas	gorilla
seminaristas	seminarians
resurgiÃ³	resurfaced
bakersfield	bakersfield
rectÃ¡ngulos	rectangles
reeve	reeve
recepcionista	receptionist
calcetines	socks
prt	trp
planteados	posed
marshal	marshal
hijastro	stepson
callado	quiet
redding	redding
subproducto	byproduct
respaldados	backed
caligari	caligari
escobas	brooms
ducati	ducati
poum	poum
stearns	stearns
sayid	sayid
ager	ager
monika	monika
eurodance	eurodance
amarrado	moored
contemplada	contemplated
lizardo	lizardo
torrens	torrens
igualitaria	egalitarian
ohne	ohne
brenner	brenner
ezcurra	ezcurra
freund	freund
germaine	germaine
corse	corse
aleph	aleph
mimbre	wicker
metallum	metallum
restar	subtract
restar	subtracting
brodie	brodie
objetivas	objective
trenzas	braids
monstruoso	monstrous
infinitivo	infinitive
lessing	lessing
honorem	honorem
desviarse	deviate
officinale	officinale
dialogo	dialogue
levallois	levallois
vitry	vitry
confidencialidad	confidentiality
confidencialidad	privacy
indestructible	indestructible
domicio	domitius
chayanne	chayanne
navega	browse
alfie	alfie
aserradero	sawmill
imprudente	unwise
imprudente	reckless
imprudente	imprudent
hcl	hcl
Ã¡gua	Ã¡gua
carmo	carmo
krishnan	krishnan
nito	nito
pastaza	pastaza
fatima	fatima
ostrava	ostrava
esperaron	waited
asociativa	associative
siemerink	siemerink
mentÃ³n	chin
dolorosos	painful
suprimiendo	suppressing
escoria	scum
escoria	slag
escoria	scumbag
finalidades	aims
fanzines	fanzines
girasoles	sunflowers
campanella	campanella
gorriones	sparrows
borland	borland
ecografÃ­a	ultrasound
suavizar	soften
suavizar	smoothing
Ã­ndigo	indigo
csp	csp
sugita	sugita
hipotensiÃ³n	hypotension
warbler	warbler
soundgarden	soundgarden
iche	iche
cardenas	cardenas
transfusiÃ³n	transfusion
adicta	addicted
adicta	addict
portavoces	spokespersons
portavoces	spokesmen
aerosol	spray
aerosol	aerosol
glock	glock
asclepio	asclepius
prÃ³fugo	fugitive
ranma	ranma
jeux	jeux
presagio	harbinger
presagio	omen
presagio	omens
teca	teak
kiwi	kiwi
mikan	mikan
selectividad	selectivity
selectividad	selective
boleslao	bolesÅ‚aw
mÃ¢con	mÃ¢con
diversificar	diversifying
diversificar	diversify
harlow	harlow
encantados	enchanted
encantados	charmed
encantados	delighted
andreev	andreev
restablece	resets
trini	trini
hatshepsut	hatshepsut
chaux	chaux
thrillers	thrillers
financiadas	financed
ejemplifica	exemplifies
spitzer	spitzer
recurrido	resorted
gollum	gollum
callar	shush
reaparecer	reappear
hagar	hagar
empoli	empoli
rhea	rhea
macleod	macleod
manjar	delicacy
amanece	dawns
gaÃ«l	gaÃ«l
goryeo	goryeo
occitania	occitania
descartando	discarding
parÃ©nquima	parenchyma
pedicelo	pedicel
drury	drury
tutmosis	thutmose
fosfatasa	phosphatase
regino	regino
geass	geass
morava	morava
casiano	casiano
pikachu	pikachu
sapindaceae	sapindaceae
entretenida	entertaining
haiku	haiku
magi	magi
palin	palin
neutralizado	neutralized
neutralizado	neutralised
pfaff	pfaff
cubeta	bucket
citoesqueleto	cytoskeleton
nymphaea	nymphaea
rectal	rectal
logarÃ­tmica	logarithmic
simeone	simeone
estes	estes
reformismo	reformism
evgeny	evgeny
passer	passer
pixie	pixie
kirkpatrick	kirkpatrick
yorktown	yorktown
fong	fong
anÃ¡logamente	similarly
xilema	xylem
kala	kala
chiudinelli	chiudinelli
capoeira	capoeira
espanto	horror
espanto	fright
contemplativa	contemplative
mÃªme	mÃªme
daviess	daviess
estratagema	stratagem
estratagema	ploy
baremo	scale
tecnica	technical
tecnica	technique
remunerado	remunerated
soiusa	soiusa
neurolÃ³gico	neurological
instantÃ¡neas	instant
instantÃ¡neas	snapshots
instantÃ¡neas	snapshot
follies	follies
arctostaphylos	arctostaphylos
petits	petits
distribuyendo	distributing
sejm	sejm
alquimistas	alchemists
inna	inna
arrianismo	arianism
vite	vite
licia	lycia
quichua	quichua
temÃ­stocles	themistocles
etnÃ³logo	ethnologist
ballenera	whaling
impala	impala
giuliani	giuliani
ponts	ponts
rollin	rollin
reiter	reiter
bonaventura	bonaventura
kido	kido
arrese	arrese
eunice	eunice
repatriados	repatriated
repatriados	returnees
oss	oss
weller	weller
dominika	dominika
rajeev	rajeev
renga	renga
ronaldinho	ronaldinho
ifam	ifam
reestructurar	restructure
ingo	ingo
azua	azua
mojarra	crappie
benita	benita
tsu	tsu
silabario	syllabary
minar	undermine
retour	retour
nivelaciÃ³n	equalization
nivelaciÃ³n	leveling
nivelaciÃ³n	levelling
dahlgren	dahlgren
raimondo	raimondo
morfemas	morphemes
peronÃ©	fibula
stallman	stallman
electrificada	electrified
huallaga	huallaga
prenatal	antenatal
prenatal	prenatal
tÃ³tem	totem
reptilia	reptilia
frawley	frawley
mehdi	mehdi
owain	owain
isÃ³mero	isomer
riki	riki
satisfactorios	satisfactory
filatelia	philately
jorasÃ¡n	khorasan
calabozos	dungeons
umbrales	threshold
umbrales	thresholds
dibley	dibley
gifu	gifu
tvc	tvc
gpp	gpp
rÃ¡dio	rÃ¡dio
klee	klee
informantes	informers
informantes	informants
feriados	holidays
dekker	dekker
paeonia	paeonia
preservando	preserving
smartphones	smartphone
smartphones	smartphones
cinemateca	cinematheque
julianne	julianne
escorbuto	scurvy
coriacea	coriacea
heinemann	heinemann
punctatus	punctatus
garmisch	garmisch
hamasaki	hamasaki
constrictor	constrictor
joni	joni
chipriotas	cypriot
chipriotas	cypriots
trina	trina
correggio	correggio
cercados	fencing
cercados	fences
cercados	pens
escatologÃ­a	eschatology
confesado	confessed
velazco	velazco
ota	ota
infalible	infallible
infalible	foolproof
fairmaire	fairmaire
sutras	sutras
cdi	cdi
cdi	ilc
cesto	basket
cesto	hamper
gallup	gallup
roadabr	roadabr
combativo	combative
phillipe	phillipe
schule	schule
mcquillan	mcquillan
silvestris	silvestris
ermitaÃ±os	hermits
flaminio	flaminio
stripper	stripper
ainhoa	ainhoa
urd	urd
respetables	respectable
willoughby	willoughby
paraiso	paradise
mandibular	mandibular
desplegable	dropdown
hexadecimal	hexadecimal
desproporcionada	disproportionate
grossa	grossa
adnan	adnan
ojivas	warhead
ojivas	warheads
cÃ¡taros	cathars
austerlitz	austerlitz
kwang	kwang
tzu	tzu
fÃ¡bio	fÃ¡bio
dunk	dunk
kos	kos
hacking	hacking
guijarros	pebbles
barris	barris
hoppe	hoppe
victoire	victoire
baek	baek
tozzi	tozzi
barcia	barcia
masterchef	masterchef
burnout	burnout
goolagong	goolagong
pani	pani
eratÃ³stenes	eratosthenes
gaara	gaara
generale	generale
anarco	anarcho
hermafrodita	hermaphrodite
Ã¥land	Ã¥land
aloud	aloud
hedwig	hedwig
stig	stig
ciclÃ³nica	cyclonic
hooke	hooke
mesolÃ­tico	mesolithic
fresnillo	fresnillo
ingerido	ingested
ginsberg	ginsberg
furio	furio
cremaciÃ³n	cremation
michonne	michonne
polylepis	polylepis
rafe	rafe
kunitsyn	kunitsyn
amerindias	amerindian
pachamama	pachamama
maniquÃ­	dummy
maniquÃ­	mannequin
cayena	cayenne
boole	boole
goldschmidt	goldschmidt
tangencial	tangential
blogueros	bloggers
araguaia	araguaia
ilÃ­aca	iliac
gedichte	gedichte
sÃºplicas	pleas
sÃºplicas	pleading
tannhÃ¤user	tannhÃ¤user
aynaoui	aynaoui
antesis	anthesis
sÃ¸rensen	sÃ¸rensen
#los	#the
hinton	hinton
frankfurter	frankfurter
amabilis	amabilis
sumidero	sink
sumidero	sinkhole
harling	harling
agripina	agrippina
landtag	landtag
deutschlands	deutschlands
caritas	caritas
maisons	maisons
extensor	extender
ayatolÃ¡	ayatollah
nakhon	nakhon
nance	nance
oliverio	oliverio
velasquez	velasquez
atestiguado	attested
lage	lage
mtk	mtk
lareau	lareau
oldman	oldman
html}}	html}}
savchuk	savchuk
syfy	syfy
middletown	middletown
salou	salou
raimi	raimi
ribosomas	ribosomes
moscovitas	muscovites
meissner	meissner
aurigae	aurigae
sohc	sohc
soplado	blowing
soplado	blown
terrero	terrero
vivendi	vivendi
laporta	laporta
jahrbuch	jahrbuch
indigentes	destitute
indigentes	indigent
indigentes	homeless
dreyer	dreyer
exterminador	exterminator
exterminador	terminator
bessie	bessie
astringente	astringent
reincidencia	recidivism
prue	prue
aroostook	aroostook
prescribe	prescribes
gatsby	gatsby
cinque	cinque
schwarzschild	schwarzschild
kearny	kearny
backus	backus
rayne	rayne
brotar	sprout
saverio	saverio
banff	banff
otello	otello
zarra	zarra
ncis	ncis
barnsley	barnsley
medford	medford
sdk	sdk
trÃ¡gicas	tragic
cuÃ±as	wedges
takagi	takagi
carrito	basket
carrito	trolley
carrito	stroller
carrito	cart
wilfrid	wilfrid
aplacar	placate
szabÃ³	szabÃ³
diptongo	diphthong
copil	copil
cannonball	cannonball
incÃ³gnitas	unknowns
valse	valse
psidium	psidium
gaon	gaon
hojalata	tin
buru	buru
reveladas	revealed
citosol	cytosol
ronin	ronin
preguntÃ©	asked
forlÃ¡n	forlÃ¡n
incubus	incubus
auditorÃ­as	audit
auditorÃ­as	audits
auditorÃ­as	auditing
joubert	joubert
kenta	kenta
militaris	militaris
ord	ord
adaptadores	adapters
bosworth	bosworth
leme	leme
samuelson	samuelson
dedicarÃ¡	dedicate
gallaecia	gallaecia
tibor	tibor
kaki	kaki
manal	manal
aubigny	aubigny
retractÃ³	retracted
htv	htv
ardid	ruse
oswego	oswego
verga	dicks
verga	dick
verga	cock
gtx	gtx
oftalmÃ³logo	ophthalmologist
corpulento	portly
kaede	kaede
inminencia	imminence
turborreactor	turbojet
barcaza	barge
velutina	velutina
vian	vian
nesbitt	nesbitt
narva	narva
stratton	stratton
consumar	consummate
revuelto	stirred
revuelto	scrambled
revuelto	scramble
schmitz	schmitz
augurio	omen
augurio	omens
dÃºplex	duplex
atribuible	attributable
ultrasonidos	ultrasound
ultrasonidos	ultrasonic
melanina	melanin
baldi	baldi
esopo	aesop
sincronizados	synced
sincronizados	synchronised
sincronizados	synchronized
dorn	dorn
doki	doki
delantal	apron
delantal	aprons
trol	troll
sambo	sambo
doohan	doohan
cabalgando	riding
rfs	rfs
genesee	genesee
indiscriminadamente	indiscriminately
indiscriminadamente	indiscriminate
suturas	sutures
suturas	stitches
osten	osten
hue	hue
tiana	tiana
insuperable	insurmountable
insuperable	unbeatable
insuperable	unsurpassed
minden	minden
orfebres	goldsmiths
silogismo	syllogism
dunal	dunal
eilat	eilat
filisteos	philistines
furiosos	furious
megavatios	megawatts
ueno	ueno
mene	mene
valeroso	courageous
valeroso	valiant
zegers	zegers
fipresci	fipresci
santini	santini
eurofighter	eurofighter
efigies	effigies
patillas	sideburns
hinds	hinds
heerenveen	heerenveen
integrador	integrative
integrador	inclusive
ullman	ullman
magik	magik
ackermann	ackermann
agendas	agendas
idealizaciÃ³n	idealization
shotokan	shotokan
cou	cou
espasmos	spasms
espasmos	spasm
interrumpiendo	aborting
interrumpiendo	interrupting
rusk	rusk
trs	trs
graÃ§a	graÃ§a
shibata	shibata
atÃ­picos	atypical
chechena	chechen
zucker	zucker
sterne	sterne
modula	modulates
pictus	pictus
conservacionista	conservationist
arrigo	arrigo
tufts	tufts
schrader	schrader
dormiciÃ³n	dormition
vasek	vasek
guzmania	guzmania
reiteraciÃ³n	reiteration
rau	rau
heraldos	heralds
bordaberry	bordaberry
marmota	groundhog
igp	pgi
kieran	kieran
anselm	anselm
pissarro	pissarro
rachid	rachid
hula	hula
brunetti	brunetti
caddo	caddo
camarines	camarines
peninos	pennine
pickford	pickford
broome	broome
ning	ning
castelnuovo	castelnuovo
doro	doro
reingreso	reentry
holtz	holtz
villes	villes
hurd	hurd
macondo	macondo
bellis	bellis
busters	busters
amenemhat	amenemhat
edi	edi
learjet	learjet
maugham	maugham
Å‚ukasz	Å‚ukasz
yomiuri	yomiuri
cebras	zebras
cebras	zebra
multifuncional	multifunctional
pogromos	pogroms
iscariote	iscariot
yad	yad
dominici	dominici
cobardes	cowards
cobardes	coward
opacidad	opacity
kermit	kermit
buarque	buarque
validado	validated
ictiosaurios	ichthyosaurs
kinabalu	kinabalu
coronata	coronata
gmc	gmc
favela	favela
reial	reial
heatseekers	heatseekers
mignon	mignon
corman	corman
passy	passy
sÃ³lidamente	solidly
acreciÃ³n	accretion
catelyn	catelyn
salins	salins
delisle	delisle
michaux	michaux
benedito	benedito
sarli	sarli
palmeri	palmeri
stasi	stasi
trekking	trekking
haji	haji
marsalis	marsalis
naacp	naacp
heinlein	heinlein
beograd	beograd
carica	carica
carteret	carteret
categÃ³ricamente	categorically
canguros	kangaroo
canguros	babysitters
canguros	kangaroos
canguros	nannies
rensselaer	rensselaer
burdeles	brothels
latine	latine
suffectus	suffectus
hipotermia	hypothermia
provins	provins
privat	privat
mcd	mcd
sif	ris
microscopios	microscopes
gattung	gattung
genealÃ³gicas	genealogical
naru	naru
lakota	lakota
comite	committee
saffir	saffir
pompilio	pompilius
burgdorf	burgdorf
cortana	cortana
estampida	stampede
defienda	defends
mhnt	mhnt
inculcar	instil
inculcar	instill
nargiso	nargiso
kuk	kuk
hayato	hayato
chievo	chievo
bÃ­ceps	biceps
martiÄ‡	martiÄ‡
escuderos	squires
biff	biff
bellamente	beautifully
virens	virens
culpado	blamed
undead	undead
eliminaciones	eliminations
mahone	mahone
rcs	rcs
sufi	sufi
funakoshi	funakoshi
seseli	seseli
southland	southland
habenaria	habenaria
beatmania	beatmania
idi	idi
insolvencia	insolvency
abdulaziz	abdulaziz
luma	luma
fonovisa	fonovisa
inmoralidad	immorality
hudgens	hudgens
piraÃ±as	piranhas
mss	mss
brockhaus	brockhaus
pilsener	pilsener
benin	beninese
benin	benin
leith	leith
lexi	lexi
ebanista	cabinetmaker
silverstein	silverstein
staatliche	staatliche
lando	lando
kbps	kbps
na+	na+
hadrones	hadron
mingus	mingus
aculturaciÃ³n	acculturation
ntsb	ntsb
puranas	puranas
hocevar	hocevar
susumu	susumu
jeffery	jeffery
reconstruyendo	reconstructing
reconstruyendo	rebuilding
evelio	evelio
aspergillus	aspergillus
abandonen	abandon
prb	prb
fudge	fudge
ccs	ccs
broz	broz
kubala	kubala
emula	emulates
centralis	centralis
moviliza	mobilizes
moviliza	mobilize
geist	geist
stomp	stomp
kiryat	kiryat
oem	oem
aiguille	aiguille
lovelace	lovelace
thunderbolts	thunderbolts
boinas	berets
nds	nds
radianes	radians
kantÅ	kantÅ
erving	erving
yitzhak	yitzhak
zia	zia
fontane	fontane
rosarito	rosarito
reproche	reproach
reproche	rebuke
yekaterina	yekaterina
rossy	rossy
civilizado	civilized
civilizado	civilised
bory	bory
suministrando	supplying
presionados	pressured
folsom	folsom
hybrida	hybrida
spandau	spandau
vittore	vittore
fiduciario	fiduciary
fiduciario	trustee
janette	janette
biÃ³ticos	biotic
justificadas	justified
pÃ¡la	pÃ¡la
fen	fen
akenatÃ³n	akhenaten
moyÃ 	moyÃ 
lagash	lagash
fidelis	fidelis
kasai	kasai
honvÃ©d	honvÃ©d
visas	visas
tenenbaum	tenenbaum
kirov	kirov
bultos	packages
ratp	ratp
piÃ©	foot
noonan	noonan
phasianidae	phasianidae
ontolÃ³gica	ontological
finis	finis
saciedad	satiety
dap	dap
patentada	patented
villamarÃ­n	villamarÃ­n
obstructiva	obstructive
fushimi	fushimi
diz	diz
matthÃ¤us	matthÃ¤us
varicela	varicella
elwood	elwood
inxs	inxs
odios	hatred
odios	hates
falo	phallus
reginaldo	reginaldo
gibert	gibert
mielina	myelin
rasta	rasta
malherbe	malherbe
urticaria	hives
urticaria	urticaria
stÃ©phanie	stÃ©phanie
saskatoon	saskatoon
rutinario	routine
legibilidad	legibility
legibilidad	readability
refrescar	freshen
refrescar	refresh
ili	ili
cottbus	cottbus
cnh	cnh
retrocediendo	retreating
retrocediendo	receding
globetrotters	globetrotters
rmx	rmx
mirim	mirim
filetes	steak
filetes	fillets
filetes	steaks
hornsby	hornsby
caputo	caputo
graebner	graebner
wenders	wenders
cre	cre
pipistrellus	pipistrellus
triptÃ³fano	tryptophan
anacardiaceae	anacardiaceae
preventivos	preventive
preventivos	preventative
milligan	milligan
kurstin	kurstin
estante	shelf
flagg	flagg
nef	nef
arginina	arginine
memorie	memorie
gorrochategui	gorrochategui
volumÃ©trico	volumetric
dory	dory
zayn	zayn
deimos	deimos
fenotipos	phenotypes
maglia	maglia
agesilao	agesilaus
fougÃ¨res	fougÃ¨res
chal	shawl
nabis	nabis
torcida	crooked
lashley	lashley
temesvÃ¡ri	temesvÃ¡ri
fagocitosis	phagocytosis
cataÃ±o	cataÃ±o
amatista	amethyst
mdma	mdma
smalltalk	smalltalk
coleta	ponytail
comprenda	comprehend
comprenda	understand
cotizar	quote
palmyra	palmyra
carling	carling
orth	orth
beattie	beattie
positrones	positrons
zabka	zabka
tes	teas
tes	tes
rhinolophus	rhinolophus
noch	noch
jenni	jenni
ballantine	ballantine
torrÃ³	torrÃ³
umag	umag
matlock	matlock
relÃ©s	relays
sacudido	rocked
sacudido	shaken
toallas	towels
papillon	papillon
pratchett	pratchett
modelizaciÃ³n	modelling
thonon	thonon
gere	gere
shafei	shafei
invÃ¡lida	invalid
impactando	impacting
vlado	vlado
alimentadores	feeders
cif	cif
allo	allo
voivoda	voivode
carpelo	carpel
catarsis	catharsis
menhir	menhir
gracile	gracile
hordaland	hordaland
carra	carra
apan	apan
nefasto	nefarious
eragrostis	eragrostis
simmonds	simmonds
brentford	brentford
mundus	mundus
fromberg	fromberg
agarrÃ³	grabbed
bilardo	bilardo
fla	fla
cydia	cydia
espacioso	spacious
espacioso	roomy
arci	arci
ampezzo	ampezzo
gradaciÃ³n	gradation
jukebox	jukebox
subcutÃ¡nea	subcutaneous
gainsboro	gainsboro
baia	baia
bisturÃ­	scalpel
pavillon	pavillon
yeo	yeo
kase	kase
camerin	camerin
mazama	mazama
montefeltro	montefeltro
courcelles	courcelles
aburre	bores
boney	boney
llewellyn	llewellyn
isengard	isengard
gratia	gratia
rodio	rhodium
reik	reik
oligarcas	oligarchs
gerstein	gerstein
arr	arr
loterÃ­as	lotteries
merovingios	merovingians
arvizu	arvizu
shugo	shugo
tazewell	tazewell
subcutÃ¡neo	subcutaneous
scripps	scripps
intramuscular	intramuscular
toms	toms
jacco	jacco
numberofusers	numberofusers
jonios	ionians
espumoso	bubbly
espumoso	sparkling
inmadura	immature
relicarios	reliquaries
yoshitaka	yoshitaka
benevolente	benevolent
urartu	urartu
sumisa	submissive
consagrantes	consecrators
nostri	nostri
megamix	megamix
kavanagh	kavanagh
watashi	watashi
demarco	demarco
baillon	baillon
imponible	taxable
overton	overton
grandin	grandin
beisbol	baseball
kean	kean
pruebe	try
bertolini	bertolini
linense	linense
neutraliza	neutralizes
inmunizaciÃ³n	immunisation
inmunizaciÃ³n	immunization
peca	freckle
arbre	arbre
psychotria	psychotria
missoula	missoula
liberti	liberti
noda	noda
dsl	dsl
nachrichten	nachrichten
impune	unpunished
facultativos	physicians
petites	petites
Äech	Äech
diplo	diplo
salford	salford
fianna	fianna
evaluador	evaluator
evaluador	assessor
comparta	share
bhp	bhp
kubo	kubo
ankh	ankh
lowndes	lowndes
caldara	caldara
arlette	arlette
grzegorz	grzegorz
atascado	stuck
atascado	jammed
atascado	stalled
pipil	pipil
matadores	matadors
serrallo	seraglio
youngstown	youngstown
peshawar	peshawar
sinÃ©ad	sinÃ©ad
tav	tav
injustificado	unwarranted
injustificado	unjustified
endocarditis	endocarditis
kilobytes	kilobytes
biscayne	biscayne
mccabe	mccabe
amf	mfa
chagos	chagos
chewbacca	chewbacca
altai	altai
peliculas	films
peliculas	movies
mayall	mayall
dacios	dacians
becca	becca
jajaja	lol
jajaja	hahaha
temeraria	reckless
scuti	scuti
vladimÃ­r	vladimÃ­r
schiffer	schiffer
escanear	scanning
escanear	scan
citroen	citroen
pirofosfato	pyrophosphate
salus	salus
papo	papo
criptogrÃ¡ficos	cryptographic
revienta	busting
aitkin	aitkin
burocrÃ¡ticas	bureaucratic
sumariamente	summarily
sacudir	jiggle
sacudir	shake
presunciones	presumptions
presunciones	assumptions
paulinho	paulinho
spitsbergen	spitsbergen
darpa	darpa
mcp	mcp
coquetea	flirts
meltzer	meltzer
autentificaciÃ³n	authentication
autentificaciÃ³n	authenticate
crispin	crispin
vereins	vereins
mainframe	mainframe
fura	fura
sturges	sturges
ibu	ibu
mustelidae	mustelidae
bernicia	bernicia
gamespy	gamespy
murilo	murilo
gouveia	gouveia
aledo	aledo
inflata	inflata
pfg	pfg
motti	motti
conica	conica
lassie	lassie
recordarle	remind
pinnata	pinnata
pÃ©cs	pÃ©cs
analisis	analysis
Ã©lan	Ã©lan
biotopos	biotopes
uia	uia
confieso	confess
ics	ics
qos	qos
jasmin	jasmin
nijmegen	nijmegen
pininfarina	pininfarina
ulvaeus	ulvaeus
deuve	deuve
rambler	rambler
paice	paice
oficiar	officiate
imogen	imogen
nob	nob
malenko	malenko
incesantes	ceaseless
incesantes	incessant
mayday	mayday
gajbe	gajbe
trÃ¡nsitos	transits
icona	icona
brocha	brush
brocha	paintbrush
bue	bue
slava	slava
tomljanoviÄ‡	tomljanoviÄ‡
jugosa	juicy
uryÅ«	uryÅ«
webcast	webcast
ulan	ulan
ponentes	presenters
ponentes	speakers
ponentes	rapporteurs
anfa	anfa
doreen	doreen
confirmaciones	confirmations
jacquet	jacquet
lucknow	lucknow
zord	zord